"","fish_id","bin","LLLL","LLLR","LLRL","LLRR","LRLL","LRLR","LRRL","LRRR","RLLL","RLLR","RLRL","RLRR","RRLL","RRLR","RRRL","RRRR","L","R","total_turns","reps","alts","rel_reps","rel_alts","rel_R","rel_L"
"1","1","1",1,3,3,5,4,6,6,7,4,5,7,8,4,9,7,11,38,55,93,12,13,12.9032258064516,13.9784946236559,59.1397849462366,40.8602150537634
"2","1","2",13,4,4,3,3,5,2,5,4,2,5,4,3,4,5,9,41,37,78,22,10,28.2051282051282,12.8205128205128,47.4358974358974,52.5641025641026
"3","1","3",2,1,1,1,1,2,3,2,1,1,2,4,1,4,3,3,14,21,35,5,4,14.2857142857143,11.4285714285714,60,40
"4","1","4",4,5,6,3,3,5,2,3,5,4,2,3,5,0,3,0,32,24,56,4,7,7.14285714285714,12.5,42.8571428571429,57.1428571428571
"5","1","5",7,4,1,2,1,1,1,2,3,0,1,1,2,1,2,0,21,11,32,7,2,21.875,6.25,34.375,65.625
"6","1","6",0,0,2,2,1,6,5,1,0,3,5,4,2,4,1,0,18,21,39,0,11,0,28.2051282051282,53.8461538461538,46.1538461538462
"7","10","1",1,3,3,4,3,8,5,7,3,4,8,8,4,7,6,11,34,54,88,12,16,13.6363636363636,18.1818181818182,61.3636363636364,38.6363636363636
"8","10","2",1,3,2,3,1,3,6,7,3,3,2,10,5,8,7,24,28,63,91,25,5,27.4725274725275,5.49450549450549,69.2307692307692,30.7692307692308
"9","10","3",3,1,2,4,3,6,6,7,1,5,7,9,3,11,7,12,33,57,90,15,13,16.6666666666667,14.4444444444444,63.3333333333333,36.6666666666667
"10","10","4",0,0,0,0,0,4,0,2,0,0,5,1,0,2,2,11,8,22,30,11,9,36.6666666666667,30,73.3333333333333,26.6666666666667
"11","10","5",0,0,0,1,0,12,1,1,0,1,13,1,1,1,1,1,17,20,37,1,25,2.7027027027027,67.5675675675676,54.0540540540541,45.9459459459459
"12","10","6",0,0,1,0,0,7,2,3,0,1,6,4,1,3,2,6,13,26,39,6,13,15.3846153846154,33.3333333333333,66.6666666666667,33.3333333333333
"13","11","1",19,9,10,6,9,11,4,7,9,7,11,5,6,5,7,5,77,56,133,24,22,18.0451127819549,16.5413533834586,42.1052631578947,57.8947368421053
"14","11","2",6,9,12,3,10,13,5,6,9,6,12,8,5,7,6,3,66,57,123,9,25,7.31707317073171,20.3252032520325,46.3414634146341,53.6585365853659
"15","11","3",23,8,7,4,5,8,5,2,9,3,6,3,7,1,2,0,65,31,96,23,14,23.9583333333333,14.5833333333333,32.2916666666667,67.7083333333333
"16","11","4",23,9,10,2,12,4,4,0,9,3,5,2,0,4,0,0,65,25,90,23,9,25.5555555555556,10,27.7777777777778,72.2222222222222
"17","11","5",11,5,5,3,4,6,5,3,5,2,6,5,3,5,3,2,44,32,76,13,12,17.1052631578947,15.7894736842105,42.1052631578947,57.8947368421053
"18","11","6",8,7,6,4,5,5,6,3,8,3,4,5,5,4,3,3,47,35,82,11,9,13.4146341463415,10.9756097560976,42.6829268292683,57.3170731707317
"19","12","1",12,8,7,8,9,7,4,8,8,7,9,5,5,7,8,7,64,58,122,19,16,15.5737704918033,13.1147540983607,47.5409836065574,52.4590163934426
"20","12","2",1,4,9,5,7,11,7,5,4,10,9,7,7,5,4,1,49,50,99,2,20,2.02020202020202,20.2020202020202,50.5050505050505,49.4949494949495
"21","12","3",18,9,10,3,8,3,5,1,9,4,1,3,5,1,1,0,60,24,84,18,4,21.4285714285714,4.76190476190476,28.5714285714286,71.4285714285714
"22","12","4",17,5,6,2,5,5,3,2,6,3,4,3,4,2,2,1,48,25,73,18,9,24.6575342465753,12.3287671232877,34.2465753424658,65.7534246575343
"23","12","5",16,5,4,2,5,5,1,1,4,1,6,0,0,1,1,1,40,16,56,17,11,30.3571428571429,19.6428571428571,28.5714285714286,71.4285714285714
"24","12","6",13,4,7,1,6,4,3,0,5,4,3,2,3,1,0,0,41,18,59,13,7,22.0338983050847,11.864406779661,30.5084745762712,69.4915254237288
"25","13","1",2,6,7,9,4,10,5,12,6,10,7,7,12,4,12,14,56,74,130,16,17,12.3076923076923,13.0769230769231,56.9230769230769,43.0769230769231
"26","13","2",30,7,5,8,7,5,5,5,7,6,6,2,6,3,5,4,73,41,114,34,11,29.8245614035088,9.64912280701754,35.9649122807018,64.0350877192982
"27","13","3",11,9,6,8,7,6,4,11,8,5,7,7,6,8,10,6,62,60,122,17,13,13.9344262295082,10.655737704918,49.1803278688525,50.8196721311475
"28","13","4",4,8,7,8,8,8,11,4,8,7,9,7,6,8,4,2,59,53,112,6,17,5.35714285714286,15.1785714285714,47.3214285714286,52.6785714285714
"29","13","5",5,6,5,6,6,10,5,4,6,5,11,3,4,5,4,5,48,45,93,10,21,10.752688172043,22.5806451612903,48.3870967741936,51.6129032258064
"30","13","6",8,4,8,4,5,13,5,2,4,8,10,3,7,0,2,0,51,35,86,8,23,9.30232558139535,26.7441860465116,40.6976744186046,59.3023255813954
"31","14","1",0,1,2,0,1,9,1,1,0,1,9,2,0,2,1,4,17,20,37,4,18,10.8108108108108,48.6486486486486,54.0540540540541,45.9459459459459
"32","14","2",2,6,6,3,6,10,3,3,5,4,10,3,3,3,3,1,41,33,74,3,20,4.05405405405405,27.027027027027,44.5945945945946,55.4054054054054
"33","14","3",2,5,18,2,19,261,13,2,5,15,262,13,1,14,2,0,324,313,637,2,523,0.313971742543171,82.1036106750392,49.1365777080063,50.8634222919937
"34","14","4",0,2,18,0,18,564,18,3,2,16,565,21,0,21,3,0,625,629,1254,0,1129,0,90.0318979266348,50.1594896331738,49.8405103668262
"35","14","5",0,1,14,0,13,595,12,0,0,13,595,12,0,12,0,0,637,633,1270,0,1190,0,93.7007874015748,49.8425196850394,50.1574803149606
"36","14","6",0,0,24,0,24,537,25,0,0,24,537,25,0,25,0,0,611,613,1224,0,1074,0,87.7450980392157,50.0816993464052,49.9183006535948
"37","15","1",9,6,10,2,7,17,7,4,6,5,14,9,4,6,4,2,63,52,115,11,31,9.56521739130435,26.9565217391304,45.2173913043478,54.7826086956522
"38","15","2",4,4,11,3,10,10,5,2,4,10,9,5,4,3,2,7,50,46,96,11,19,11.4583333333333,19.7916666666667,47.9166666666667,52.0833333333333
"39","15","3",4,5,3,3,3,4,6,2,4,1,5,5,2,6,2,5,32,31,63,9,9,14.2857142857143,14.2857142857143,49.2063492063492,50.7936507936508
"40","15","4",0,1,1,4,1,25,6,1,1,4,25,3,3,4,1,1,40,44,84,1,50,1.19047619047619,59.5238095238095,52.3809523809524,47.6190476190476
"41","15","5",0,0,0,1,1,26,1,0,0,1,26,0,0,1,0,0,30,30,60,0,52,0,86.6666666666667,50,50
"42","15","6",1,1,1,2,3,20,2,0,1,2,22,0,0,2,0,0,32,28,60,1,42,1.66666666666667,70,46.6666666666667,53.3333333333333
"43","16","1",0,1,4,2,2,17,7,2,1,5,15,7,4,5,2,2,36,43,79,2,32,2.53164556962025,40.5063291139241,54.4303797468354,45.5696202531646
"44","16","2",8,8,8,5,5,18,12,1,8,6,15,8,8,5,1,0,67,52,119,8,33,6.72268907563025,27.7310924369748,43.6974789915966,56.3025210084034
"45","16","3",11,8,10,3,10,13,5,0,8,5,12,2,3,2,0,0,61,34,95,11,25,11.5789473684211,26.3157894736842,35.7894736842105,64.2105263157895
"46","16","4",12,7,8,5,11,8,7,0,7,6,11,2,2,5,0,0,61,33,94,12,19,12.7659574468085,20.2127659574468,35.1063829787234,64.8936170212766
"47","16","5",16,7,9,3,7,7,4,2,7,5,5,3,5,1,2,0,56,30,86,16,12,18.6046511627907,13.953488372093,34.8837209302326,65.1162790697674
"48","16","6",17,8,7,5,7,2,6,1,9,4,2,1,6,1,1,2,56,26,82,19,4,23.1707317073171,4.8780487804878,31.7073170731707,68.2926829268293
"49","17","1",4,2,4,4,5,4,4,0,2,6,5,1,2,2,0,0,28,20,48,4,9,8.33333333333333,18.75,41.6666666666667,58.3333333333333
"50","17","2",10,5,6,1,4,6,2,5,4,2,4,6,2,5,5,5,40,35,75,15,10,20,13.3333333333333,46.6666666666667,53.3333333333333
"51","17","3",1,2,4,5,2,3,4,7,2,7,2,5,7,4,7,8,30,43,73,9,5,12.3287671232877,6.84931506849315,58.9041095890411,41.0958904109589
"52","17","4",27,7,8,1,9,4,2,0,8,2,5,1,1,2,1,0,61,20,81,27,9,33.3333333333333,11.1111111111111,24.6913580246914,75.3086419753086
"53","17","5",53,4,3,0,3,1,0,0,3,0,1,0,0,0,0,0,66,5,71,53,2,74.6478873239437,2.8169014084507,7.04225352112676,92.9577464788732
"54","17","6",41,2,2,0,2,0,0,0,2,0,0,0,0,0,0,0,50,2,52,41,0,78.8461538461538,0,3.84615384615385,96.1538461538462
"55","18","1",3,5,9,2,5,20,7,2,5,6,16,8,6,4,3,1,54,51,105,4,36,3.80952380952381,34.2857142857143,48.5714285714286,51.4285714285714
"56","18","2",10,9,8,4,7,4,5,1,9,3,3,2,5,1,1,1,51,25,76,11,7,14.4736842105263,9.21052631578947,32.8947368421053,67.1052631578947
"57","18","3",3,3,5,5,4,7,4,4,3,7,7,3,6,3,4,1,37,35,72,4,14,5.55555555555556,19.4444444444444,48.6111111111111,51.3888888888889
"58","18","4",0,1,1,1,0,9,4,4,1,1,9,6,2,6,4,6,22,36,58,6,18,10.3448275862069,31.0344827586207,62.0689655172414,37.9310344827586
"59","18","5",0,0,2,2,3,5,4,2,0,5,6,3,2,4,2,3,20,26,46,3,11,6.52173913043478,23.9130434782609,56.5217391304348,43.4782608695652
"60","18","6",0,0,0,1,0,0,1,6,0,1,0,5,1,5,5,35,8,55,63,35,0,55.5555555555556,0,87.3015873015873,12.6984126984127
"61","19","1",4,3,5,2,5,16,3,6,3,4,15,7,2,7,6,3,45,49,94,7,31,7.4468085106383,32.9787234042553,52.1276595744681,47.8723404255319
"62","19","2",2,2,0,4,2,9,7,5,2,2,10,8,2,9,4,17,31,57,88,19,19,21.5909090909091,21.5909090909091,64.7727272727273,35.2272727272727
"63","19","3",0,2,1,4,0,3,4,6,2,3,2,6,5,5,6,25,20,57,77,25,5,32.4675324675325,6.49350649350649,74.025974025974,25.974025974026
"64","19","4",0,0,2,3,3,2,2,4,0,5,3,3,2,5,5,10,17,35,52,10,5,19.2307692307692,9.61538461538461,67.3076923076923,32.6923076923077
"65","19","5",1,1,2,1,3,3,0,3,1,2,4,2,0,3,3,10,14,28,42,11,7,26.1904761904762,16.6666666666667,66.6666666666667,33.3333333333333
"66","19","6",2,2,3,1,4,4,1,1,2,2,5,1,1,2,2,10,20,26,46,12,9,26.0869565217391,19.5652173913043,56.5217391304348,43.4782608695652
"67","2","1",0,3,7,7,8,16,9,5,3,11,18,7,6,8,5,2,57,61,118,2,34,1.69491525423729,28.8135593220339,51.6949152542373,48.3050847457627
"68","2","2",5,3,4,8,6,9,7,10,3,9,11,9,6,11,11,12,53,74,127,17,20,13.3858267716535,15.748031496063,58.2677165354331,41.7322834645669
"69","2","3",1,4,7,3,5,4,1,8,4,6,2,6,4,4,7,12,33,48,81,13,6,16.0493827160494,7.40740740740741,59.2592592592593,40.7407407407407
"70","2","4",2,1,1,3,3,10,3,2,2,3,12,2,2,3,2,3,28,29,57,5,22,8.7719298245614,38.5964912280702,50.8771929824561,49.1228070175439
"71","2","5",3,2,3,1,1,3,2,3,2,2,1,4,2,2,3,6,19,24,43,9,4,20.9302325581395,9.30232558139535,55.8139534883721,44.1860465116279
"72","2","6",1,2,3,1,3,2,0,2,3,2,2,1,2,1,3,12,17,26,43,13,4,30.2325581395349,9.30232558139535,60.4651162790698,39.5348837209302
"73","20","1",7,5,1,5,1,1,1,7,5,1,1,3,4,3,6,24,28,50,78,31,2,39.7435897435897,2.56410256410256,64.1025641025641,35.8974358974359
"74","20","2",4,3,1,3,3,5,4,9,3,1,7,9,2,11,9,7,34,50,84,11,12,13.0952380952381,14.2857142857143,59.5238095238095,40.4761904761905
"75","20","3",8,5,9,0,8,3,1,2,6,4,2,3,2,2,3,0,39,22,61,8,5,13.1147540983607,8.19672131147541,36.0655737704918,63.9344262295082
"76","20","4",16,6,8,0,6,3,1,0,5,2,2,1,1,0,0,0,42,12,54,16,5,29.6296296296296,9.25925925925926,22.2222222222222,77.7777777777778
"77","20","5",9,6,4,3,4,2,1,3,6,1,3,1,3,1,3,3,34,22,56,12,5,21.4285714285714,8.92857142857143,39.2857142857143,60.7142857142857
"78","20","6",6,5,6,1,4,5,4,0,4,3,3,3,3,1,0,0,33,18,51,6,8,11.7647058823529,15.6862745098039,35.2941176470588,64.7058823529412
"79","21","1",4,3,5,2,4,13,1,3,3,4,11,3,3,1,3,2,36,32,68,6,24,8.82352941176471,35.2941176470588,47.0588235294118,52.9411764705882
"80","21","2",1,2,2,6,6,7,8,2,3,5,11,4,2,8,2,2,37,37,74,3,18,4.05405405405405,24.3243243243243,50,50
"81","21","3",1,3,3,5,4,6,7,2,3,5,7,4,4,5,2,1,33,32,65,2,13,3.07692307692308,20,49.2307692307692,50.7692307692308
"82","21","4",2,2,1,3,2,5,2,3,2,2,6,2,3,2,3,9,22,30,52,11,11,21.1538461538462,21.1538461538462,57.6923076923077,42.3076923076923
"83","21","5",1,6,6,3,5,5,2,3,6,2,4,2,4,1,3,3,33,26,59,4,9,6.77966101694915,15.2542372881356,44.0677966101695,55.9322033898305
"84","21","6",5,4,2,6,4,2,3,3,4,3,4,0,4,2,3,1,31,22,53,6,6,11.3207547169811,11.3207547169811,41.5094339622642,58.4905660377358
"85","22","1",5,4,5,3,5,4,2,1,4,4,4,1,3,1,2,1,30,22,52,6,8,11.5384615384615,15.3846153846154,42.3076923076923,57.6923076923077
"86","22","2",4,2,1,3,2,5,6,3,2,2,7,6,2,8,3,2,28,33,61,6,12,9.83606557377049,19.672131147541,54.0983606557377,45.9016393442623
"87","22","3",11,9,8,4,10,4,4,2,9,4,6,2,3,4,2,2,54,33,87,13,10,14.9425287356322,11.4942528735632,37.9310344827586,62.0689655172414
"88","22","4",7,1,0,0,1,2,0,0,1,0,2,0,0,0,0,0,13,4,17,7,4,41.1764705882353,23.5294117647059,23.5294117647059,76.4705882352941
"89","22","5",0,0,0,0,0,0,0,0,0,0,0,0,0,0,0,0,0,0,0,0,0,NA,NA,NA,NA
"90","22","6",0,0,0,0,0,0,0,0,0,0,0,0,0,0,0,0,0,0,0,0,0,NA,NA,NA,NA
"91","23","1",5,7,9,5,10,17,6,5,7,6,19,6,3,8,5,5,66,60,126,10,36,7.93650793650794,28.5714285714286,47.6190476190476,52.3809523809524
"92","23","2",14,9,13,8,11,12,12,5,9,12,11,9,10,8,6,2,86,68,154,16,23,10.3896103896104,14.9350649350649,44.1558441558442,55.8441558441558
"93","23","3",2,6,10,5,11,10,9,3,6,10,11,7,5,7,3,5,58,55,113,7,21,6.19469026548673,18.5840707964602,48.6725663716814,51.3274336283186
"94","23","4",7,5,8,1,5,9,2,4,5,3,6,5,4,2,4,1,43,31,74,8,15,10.8108108108108,20.2702702702703,41.8918918918919,58.1081081081081
"95","23","5",10,5,6,1,5,7,3,2,6,2,5,4,3,2,2,0,42,24,66,10,12,15.1515151515152,18.1818181818182,36.3636363636364,63.6363636363636
"96","23","6",1,2,3,2,5,4,4,0,2,3,7,1,0,4,0,0,23,18,41,1,11,2.4390243902439,26.8292682926829,43.9024390243902,56.0975609756098
"97","24","1",1,2,3,3,3,10,3,6,2,4,10,6,2,7,6,13,32,52,84,14,20,16.6666666666667,23.8095238095238,61.9047619047619,38.0952380952381
"98","24","2",5,4,5,6,3,6,6,6,4,7,4,6,8,5,6,5,42,47,89,10,10,11.2359550561798,11.2359550561798,52.8089887640449,47.1910112359551
"99","24","3",0,4,6,6,5,4,6,6,4,7,3,7,6,6,6,6,38,47,85,6,7,7.05882352941176,8.23529411764706,55.2941176470588,44.7058823529412
"100","24","4",1,1,5,1,2,10,4,4,1,5,7,7,5,3,4,4,30,37,67,5,17,7.46268656716418,25.3731343283582,55.2238805970149,44.7761194029851
"101","24","5",0,4,2,2,1,6,4,3,4,0,5,5,3,4,4,6,23,33,56,6,11,10.7142857142857,19.6428571428571,58.9285714285714,41.0714285714286
"102","24","6",9,4,2,3,2,2,4,2,4,1,2,3,3,3,2,0,31,18,49,9,4,18.3673469387755,8.16326530612245,36.734693877551,63.265306122449
"103","25","1",0,1,4,1,3,6,1,1,1,3,5,1,1,1,1,3,18,18,36,3,11,8.33333333333333,30.5555555555556,50,50
"104","25","2",0,3,6,5,5,4,5,5,3,8,4,4,6,4,5,10,35,45,80,10,8,12.5,10,56.25,43.75
"105","25","3",0,1,3,1,2,6,5,6,1,3,5,10,2,9,6,14,25,52,77,14,11,18.1818181818182,14.2857142857143,67.5324675324675,32.4675324675325
"106","25","4",0,0,0,0,0,4,0,7,0,0,4,7,0,7,6,64,11,91,102,64,8,62.7450980392157,7.84313725490196,89.2156862745098,10.7843137254902
"107","25","5",0,0,0,0,0,3,0,4,0,0,3,4,0,4,4,48,7,66,73,48,6,65.7534246575343,8.21917808219178,90.4109589041096,9.58904109589041
"108","25","6",0,0,0,1,0,0,0,2,0,1,0,1,1,1,3,58,4,67,71,58,0,81.6901408450704,0,94.3661971830986,5.63380281690141
"109","26","1",1,2,6,6,7,7,8,1,2,10,8,3,6,3,1,2,40,36,76,3,15,3.94736842105263,19.7368421052632,47.3684210526316,52.6315789473684
"110","26","2",5,4,8,3,8,5,7,0,4,7,6,4,3,5,0,0,42,30,72,5,11,6.94444444444444,15.2777777777778,41.6666666666667,58.3333333333333
"111","26","3",8,6,8,3,10,7,2,2,6,5,8,1,1,2,2,1,47,28,75,9,15,12,20,37.3333333333333,62.6666666666667
"112","26","4",1,2,7,2,8,6,4,0,2,7,7,2,1,2,0,0,31,23,54,1,13,1.85185185185185,24.0740740740741,42.5925925925926,57.4074074074074
"113","26","5",6,3,2,4,4,1,1,4,3,2,3,1,1,3,3,7,25,26,51,13,4,25.4901960784314,7.84313725490196,50.9803921568627,49.0196078431373
"114","26","6",3,2,2,5,3,2,3,3,3,5,3,1,5,2,4,2,26,25,51,5,5,9.80392156862745,9.80392156862745,49.0196078431373,50.9803921568627
"115","27","1",3,5,6,8,7,7,9,7,6,9,8,8,8,9,7,11,55,66,121,14,15,11.5702479338843,12.396694214876,54.5454545454545,45.4545454545455
"116","27","2",2,5,5,7,4,3,7,6,6,7,2,6,9,5,7,4,42,46,88,6,5,6.81818181818182,5.68181818181818,52.2727272727273,47.7272727272727
"117","27","3",11,3,4,4,4,1,3,3,2,5,1,3,3,3,3,2,34,24,58,13,2,22.4137931034483,3.44827586206897,41.3793103448276,58.6206896551724
"118","27","4",13,4,5,1,5,5,1,0,4,2,5,1,1,0,0,0,35,15,50,13,10,26,20,30,70
"119","27","5",3,3,7,1,6,2,1,1,3,4,1,1,1,1,1,0,25,14,39,3,3,7.69230769230769,7.69230769230769,35.8974358974359,64.1025641025641
"120","27","6",11,4,2,2,1,4,3,2,3,0,3,3,2,2,2,1,30,18,48,12,7,25,14.5833333333333,37.5,62.5
"121","28","1",0,0,0,0,0,0,0,0,0,0,0,0,0,0,0,0,1,2,3,0,0,0,0,66.6666666666667,33.3333333333333
"122","28","2",1,1,3,0,0,11,4,1,1,2,8,5,3,2,1,0,23,23,46,1,19,2.17391304347826,41.304347826087,50,50
"123","28","3",1,2,7,4,7,12,11,12,2,10,12,19,5,19,12,25,58,105,163,26,24,15.9509202453988,14.7239263803681,64.4171779141104,35.5828220858896
"124","28","4",8,4,4,7,3,10,8,14,4,7,9,15,8,13,13,30,58,102,160,38,19,23.75,11.875,63.75,36.25
"125","28","5",1,1,2,6,2,4,7,11,1,8,4,12,7,12,12,60,36,117,153,61,8,39.8692810457516,5.22875816993464,76.4705882352941,23.5294117647059
"126","28","6",13,9,7,11,5,8,11,12,9,9,6,12,12,10,12,9,77,81,158,22,14,13.9240506329114,8.86075949367089,51.2658227848101,48.7341772151899
"127","29","1",3,3,2,0,2,3,0,0,2,0,3,0,0,0,0,0,15,6,21,3,6,14.2857142857143,28.5714285714286,28.5714285714286,71.4285714285714
"128","29","2",0,0,0,0,0,0,0,0,0,0,0,0,0,0,0,0,1,1,2,0,0,0,0,50,50
"129","29","3",0,0,0,0,0,0,0,0,0,0,0,0,0,0,0,0,1,1,2,0,0,0,0,50,50
"130","29","4",0,0,0,0,0,0,0,0,0,0,0,0,0,0,0,0,0,0,0,0,0,NA,NA,NA,NA
"131","29","5",0,0,0,0,0,0,0,0,0,0,0,0,0,0,0,0,0,2,2,0,0,0,0,100,0
"132","29","6",0,0,0,0,0,1,0,0,0,0,1,0,0,0,0,0,3,2,5,0,2,0,40,40,60
"133","3","1",22,8,10,2,8,16,6,1,8,4,14,5,4,4,1,0,74,42,116,22,30,18.9655172413793,25.8620689655172,36.2068965517241,63.7931034482759
"134","3","2",5,5,6,2,6,6,4,5,5,3,6,7,3,7,6,4,41,42,83,9,12,10.8433734939759,14.4578313253012,50.6024096385542,49.3975903614458
"135","3","3",3,2,2,6,2,13,6,4,2,6,13,4,6,5,5,1,39,44,83,4,26,4.81927710843374,31.3253012048193,53.0120481927711,46.9879518072289
"136","3","4",3,5,6,4,3,10,8,2,5,5,8,6,6,4,2,0,43,37,80,3,18,3.75,22.5,46.25,53.75
"137","3","5",0,2,6,4,7,7,5,1,2,8,8,2,3,3,1,0,33,29,62,0,15,0,24.1935483870968,46.7741935483871,53.2258064516129
"138","3","6",0,0,0,0,0,0,0,0,0,0,0,0,0,0,0,0,0,0,0,0,0,NA,NA,NA,NA
"139","30","1",0,0,1,0,1,0,0,0,0,1,1,0,0,0,0,0,4,3,7,0,1,0,14.2857142857143,42.8571428571429,57.1428571428571
"140","30","2",0,0,0,0,0,0,0,0,0,0,0,0,0,0,0,0,1,2,3,0,0,0,0,66.6666666666667,33.3333333333333
"141","30","3",0,0,0,0,0,0,0,0,0,0,0,0,0,0,0,0,0,0,0,0,0,NA,NA,NA,NA
"142","30","4",0,0,0,0,0,23,0,0,0,0,24,0,0,0,0,0,25,25,50,0,47,0,94,50,50
"143","30","5",0,0,0,0,0,0,0,0,0,0,0,0,0,0,0,0,0,0,0,0,0,NA,NA,NA,NA
"144","30","6",0,0,0,0,1,3,1,0,0,0,3,1,0,1,0,0,7,6,13,0,6,0,46.1538461538462,46.1538461538462,53.8461538461538
"145","31","1",22,12,12,5,11,16,5,5,12,5,15,5,5,5,5,4,89,58,147,26,31,17.687074829932,21.0884353741497,39.4557823129252,60.5442176870748
"146","31","2",2,5,11,3,10,16,7,2,6,9,14,6,5,4,2,3,59,49,108,5,30,4.62962962962963,27.7777777777778,45.3703703703704,54.6296296296296
"147","31","3",13,7,9,3,9,10,5,5,7,5,10,7,3,6,5,2,62,47,109,15,20,13.7614678899083,18.348623853211,43.1192660550459,56.8807339449541
"148","31","4",7,1,4,1,4,4,1,1,2,3,4,1,1,1,1,1,26,14,40,8,8,20,20,35,65
"149","31","5",17,6,6,4,6,1,3,1,6,3,2,0,3,1,1,1,46,18,64,18,3,28.125,4.6875,28.125,71.875
"150","31","6",18,3,2,3,2,2,4,0,2,2,3,1,2,2,0,0,36,13,49,18,5,36.734693877551,10.2040816326531,26.530612244898,73.469387755102
"151","32","1",2,8,9,9,6,23,6,12,8,9,20,9,11,6,11,6,75,83,158,8,43,5.06329113924051,27.2151898734177,52.5316455696203,47.4683544303797
"152","32","2",1,1,5,6,3,12,10,9,1,10,9,13,8,10,8,14,47,76,123,15,21,12.1951219512195,17.0731707317073,61.7886178861789,38.2113821138211
"153","32","3",5,2,3,5,3,14,10,11,2,6,14,17,5,16,11,9,54,82,136,14,28,10.2941176470588,20.5882352941176,60.2941176470588,39.7058823529412
"154","32","4",6,3,4,8,6,10,10,3,3,10,11,5,7,6,3,2,52,48,100,8,21,8,21,48,52
"155","32","5",0,0,0,4,3,13,7,7,0,4,16,10,1,13,7,10,35,63,98,10,29,10.2040816326531,29.5918367346939,64.2857142857143,35.7142857142857
"156","32","6",3,4,8,2,8,9,4,2,4,6,10,4,2,5,3,2,42,37,79,5,19,6.32911392405063,24.0506329113924,46.8354430379747,53.1645569620253
"157","33","1",8,4,6,3,4,5,4,3,4,5,3,3,5,2,3,4,38,31,69,12,8,17.3913043478261,11.5942028985507,44.9275362318841,55.0724637681159
"158","33","2",6,4,5,3,6,20,7,4,4,4,21,8,2,10,5,6,56,62,118,12,41,10.1694915254237,34.7457627118644,52.5423728813559,47.4576271186441
"159","33","3",1,1,4,2,3,28,7,2,1,5,27,7,4,6,2,1,50,54,104,2,55,1.92307692307692,52.8846153846154,51.9230769230769,48.0769230769231
"160","33","4",2,3,6,3,6,26,5,0,3,5,26,2,2,3,0,0,52,43,95,2,52,2.10526315789474,54.7368421052632,45.2631578947368,54.7368421052632
"161","33","5",10,7,4,2,5,18,4,1,7,0,19,3,2,3,1,1,53,37,90,11,37,12.2222222222222,41.1111111111111,41.1111111111111,58.8888888888889
"162","33","6",2,2,2,3,4,14,3,1,2,3,15,1,1,3,1,1,32,29,61,3,29,4.91803278688525,47.5409836065574,47.5409836065574,52.4590163934426
"163","34","1",7,9,13,8,10,18,10,7,9,11,15,9,10,6,6,6,82,75,157,13,33,8.28025477707006,21.0191082802548,47.7707006369427,52.2292993630573
"164","34","2",0,0,4,2,4,47,7,2,0,6,47,7,2,6,1,1,66,73,139,1,94,0.719424460431655,67.6258992805755,52.5179856115108,47.4820143884892
"165","34","3",0,0,3,3,4,21,6,4,0,6,21,7,2,7,4,2,42,51,93,2,42,2.1505376344086,45.1612903225806,54.8387096774194,45.1612903225806
"166","34","4",2,2,5,1,4,30,5,1,2,4,29,5,2,3,1,0,51,48,99,2,59,2.02020202020202,59.5959595959596,48.4848484848485,51.5151515151515
"167","34","5",16,7,9,2,8,19,5,0,7,4,18,3,3,3,1,2,67,43,110,18,37,16.3636363636364,33.6363636363636,39.0909090909091,60.9090909090909
"168","34","6",7,6,9,3,9,8,1,2,6,6,8,0,3,0,2,2,47,28,75,9,16,12,21.3333333333333,37.3333333333333,62.6666666666667
"169","35","1",9,6,11,8,12,15,8,6,7,13,15,6,8,6,6,5,78,66,144,14,30,9.72222222222222,20.8333333333333,45.8333333333333,54.1666666666667
"170","35","2",3,4,9,7,7,6,6,8,5,12,4,7,10,4,8,4,53,54,107,7,10,6.54205607476636,9.34579439252336,50.4672897196262,49.5327102803738
"171","35","3",26,14,12,6,15,1,6,4,14,5,4,3,4,6,4,5,86,46,132,31,5,23.4848484848485,3.78787878787879,34.8484848484849,65.1515151515152
"172","35","4",29,7,12,4,14,4,3,1,8,9,5,0,3,1,1,5,77,32,109,34,9,31.1926605504587,8.25688073394495,29.3577981651376,70.6422018348624
"173","35","5",12,10,10,8,8,10,7,4,10,7,8,3,9,1,4,2,70,46,116,14,18,12.0689655172414,15.5172413793103,39.6551724137931,60.3448275862069
"174","35","6",9,7,9,5,11,3,6,3,6,7,6,4,2,7,3,1,55,37,92,10,9,10.8695652173913,9.78260869565217,40.2173913043478,59.7826086956522
"175","36","1",12,9,9,5,8,11,6,5,9,5,10,5,6,5,5,4,66,51,117,16,21,13.6752136752137,17.9487179487179,43.5897435897436,56.4102564102564
"176","36","2",0,4,6,11,6,13,12,11,4,13,12,12,11,11,11,11,64,87,151,11,25,7.28476821192053,16.5562913907285,57.6158940397351,42.3841059602649
"177","36","3",1,2,8,7,10,15,6,9,2,13,17,8,4,10,8,10,58,75,133,11,32,8.27067669172932,24.0601503759398,56.390977443609,43.609022556391
"178","36","4",0,0,0,1,1,20,0,11,0,1,21,10,0,12,11,24,34,81,115,24,41,20.8695652173913,35.6521739130435,70.4347826086957,29.5652173913043
"179","36","5",0,0,0,0,0,6,0,8,0,0,7,8,0,9,9,41,16,75,91,41,13,45.0549450549451,14.2857142857143,82.4175824175824,17.5824175824176
"180","36","6",0,0,2,0,0,17,2,8,0,2,15,10,2,8,8,11,30,58,88,11,32,12.5,36.3636363636364,65.9090909090909,34.0909090909091
"181","37","1",15,13,18,8,16,10,9,4,14,13,8,5,11,2,4,1,96,58,154,16,18,10.3896103896104,11.6883116883117,37.6623376623377,62.3376623376623
"182","37","2",26,10,7,8,7,3,10,6,10,5,3,8,8,8,6,1,78,51,129,27,6,20.9302325581395,4.65116279069767,39.5348837209302,60.4651162790698
"183","37","3",14,9,3,7,6,1,7,4,10,0,4,4,4,7,4,2,54,35,89,16,5,17.9775280898876,5.61797752808989,39.3258426966292,60.6741573033708
"184","37","4",20,10,7,4,9,0,3,1,11,1,1,0,3,1,1,0,57,18,75,20,1,26.6666666666667,1.33333333333333,24,76
"185","37","5",15,6,5,3,6,2,2,1,5,2,3,1,1,2,1,1,41,18,59,16,5,27.1186440677966,8.47457627118644,30.5084745762712,69.4915254237288
"186","37","6",23,7,8,0,8,2,0,0,7,1,2,0,0,0,0,0,50,11,61,23,4,37.7049180327869,6.55737704918033,18.0327868852459,81.9672131147541
"187","38","1",2,5,6,5,7,18,10,8,5,6,19,13,5,14,8,5,63,76,139,7,37,5.03597122302158,26.6187050359712,54.6762589928058,45.3237410071942
"188","38","2",6,5,7,7,2,13,11,7,5,9,9,11,12,7,7,10,60,71,131,16,22,12.2137404580153,16.793893129771,54.1984732824427,45.8015267175573
"189","38","3",6,8,9,3,10,16,4,4,8,4,17,6,1,7,4,5,61,54,115,11,33,9.56521739130435,28.695652173913,46.9565217391304,53.0434782608696
"190","38","4",7,8,9,4,9,12,6,2,7,5,12,4,4,4,2,1,59,40,99,8,24,8.08080808080808,24.2424242424242,40.4040404040404,59.5959595959596
"191","38","5",0,0,5,2,5,30,7,4,0,7,30,9,2,8,3,1,53,63,116,1,60,0.862068965517241,51.7241379310345,54.3103448275862,45.6896551724138
"192","38","6",6,6,8,8,11,13,6,4,6,10,15,2,5,4,3,2,62,50,112,8,28,7.14285714285714,25,44.6428571428571,55.3571428571429
"193","39","1",0,0,0,0,0,0,1,0,0,0,0,1,1,0,0,0,3,3,6,0,0,0,0,50,50
"194","39","2",0,0,1,1,1,0,0,1,0,1,0,0,0,0,0,0,4,4,8,0,0,0,0,50,50
"195","39","3",0,0,0,0,0,0,0,0,0,0,0,0,0,0,0,0,0,0,0,0,0,NA,NA,NA,NA
"196","39","4",0,0,0,0,0,0,0,0,0,0,0,0,0,0,0,0,0,0,0,0,0,NA,NA,NA,NA
"197","39","5",0,0,0,0,0,0,0,0,0,0,0,0,0,0,0,0,0,0,0,0,0,NA,NA,NA,NA
"198","39","6",0,0,0,0,0,0,0,0,0,0,0,0,0,0,0,0,0,0,0,0,0,NA,NA,NA,NA
"199","4","1",0,2,4,7,6,9,11,6,2,10,11,10,6,11,6,6,47,63,110,6,20,5.45454545454545,18.1818181818182,57.2727272727273,42.7272727272727
"200","4","2",13,3,4,5,5,8,3,4,3,6,9,2,4,3,4,4,46,37,83,17,17,20.4819277108434,20.4819277108434,44.578313253012,55.421686746988
"201","4","3",1,4,9,0,8,55,3,4,4,5,54,7,2,6,5,8,86,92,178,9,109,5.0561797752809,61.2359550561798,51.685393258427,48.314606741573
"202","4","4",1,1,3,1,3,21,5,3,1,3,21,7,1,7,3,6,41,49,90,7,42,7.77777777777778,46.6666666666667,54.4444444444444,45.5555555555556
"203","4","5",5,4,6,1,5,42,4,0,4,3,40,3,2,1,0,0,68,55,123,5,82,4.0650406504065,66.6666666666667,44.7154471544715,55.2845528455285
"204","4","6",6,4,5,1,5,3,2,1,4,2,2,2,2,1,1,0,29,15,44,6,5,13.6363636363636,11.3636363636364,34.0909090909091,65.9090909090909
"205","40","1",10,9,9,6,7,6,8,5,9,7,4,7,8,5,5,7,62,53,115,17,10,14.7826086956522,8.69565217391304,46.0869565217391,53.9130434782609
"206","40","2",1,3,6,3,4,11,9,5,3,7,9,10,6,8,5,5,44,54,98,6,20,6.12244897959184,20.4081632653061,55.1020408163265,44.8979591836735
"207","40","3",3,2,3,2,4,16,5,2,2,4,17,5,2,6,2,0,39,39,78,3,33,3.84615384615385,42.3076923076923,50,50
"208","40","4",0,0,4,3,4,24,7,2,0,7,24,7,3,6,2,4,45,55,100,4,48,4,48,55,45
"209","40","5",0,0,0,0,0,48,3,0,0,0,47,3,0,3,0,0,52,55,107,0,95,0,88.785046728972,51.4018691588785,48.5981308411215
"210","40","6",0,0,0,1,0,37,1,1,0,1,36,1,1,1,1,1,41,44,85,1,73,1.17647058823529,85.8823529411765,51.7647058823529,48.2352941176471
"211","41","1",0,0,0,0,0,0,0,0,0,0,0,0,0,0,0,0,0,0,0,0,0,NA,NA,NA,NA
"212","41","2",0,0,0,0,0,0,0,0,0,0,0,0,0,0,0,0,2,0,2,0,0,0,0,0,100
"213","41","3",0,0,0,0,0,0,0,0,0,0,0,0,0,0,0,0,2,1,3,0,0,0,0,33.3333333333333,66.6666666666667
"214","41","4",0,0,0,0,0,0,0,0,0,0,0,0,0,0,0,0,0,0,0,0,0,NA,NA,NA,NA
"215","41","5",0,0,0,0,0,2,0,0,0,0,3,0,0,0,0,0,4,4,8,0,5,0,62.5,50,50
"216","41","6",0,0,0,0,0,0,0,0,0,0,0,0,0,0,0,0,0,1,1,0,0,0,0,100,0
"217","42","1",5,7,3,6,3,14,8,10,7,2,15,12,5,13,10,5,58,70,128,10,29,7.8125,22.65625,54.6875,45.3125
"218","42","2",4,8,7,5,7,19,5,8,8,4,18,8,5,7,8,9,64,69,133,13,37,9.77443609022556,27.8195488721805,51.8796992481203,48.1203007518797
"219","42","3",1,3,2,4,3,12,16,9,3,3,13,21,3,22,9,8,51,84,135,9,25,6.66666666666667,18.5185185185185,62.2222222222222,37.7777777777778
"220","42","4",1,1,5,3,2,16,7,5,1,7,13,9,6,6,5,4,41,53,94,5,29,5.31914893617021,30.8510638297872,56.3829787234043,43.6170212765957
"221","42","5",2,4,9,3,7,7,2,5,4,8,5,5,4,3,5,4,40,40,80,6,12,7.5,15,50,50
"222","42","6",2,2,3,0,1,5,3,2,2,1,4,5,1,4,2,1,20,21,41,3,9,7.31707317073171,21.9512195121951,51.219512195122,48.780487804878
"223","43","1",0,2,7,8,7,12,6,21,2,13,11,19,9,18,21,33,65,127,192,33,23,17.1875,11.9791666666667,66.1458333333333,33.8541666666667
"224","43","2",1,7,9,6,9,10,5,9,7,8,11,8,6,9,9,14,58,73,131,15,21,11.4503816793893,16.030534351145,55.7251908396947,44.2748091603053
"225","43","3",10,3,3,4,4,3,4,0,3,4,5,0,3,2,1,0,33,19,52,10,8,19.2307692307692,15.3846153846154,36.5384615384615,63.4615384615385
"226","43","4",3,2,1,2,1,2,1,0,2,1,2,0,1,0,0,0,13,8,21,3,4,14.2857142857143,19.047619047619,38.0952380952381,61.9047619047619
"227","43","5",0,1,0,1,0,0,1,1,1,0,1,1,0,2,1,1,6,8,14,1,1,7.14285714285714,7.14285714285714,57.1428571428571,42.8571428571429
"228","43","6",1,1,0,1,0,0,0,1,2,0,0,0,2,0,2,1,7,7,14,2,0,14.2857142857143,0,50,50
"229","44","1",9,7,11,4,11,15,7,3,7,8,15,6,5,6,3,0,69,51,120,9,30,7.5,25,42.5,57.5
"230","44","2",3,6,12,3,12,14,4,3,6,9,14,4,3,5,3,2,58,48,106,5,28,4.71698113207547,26.4150943396226,45.2830188679245,54.7169811320755
"231","44","3",3,1,4,2,5,30,6,2,1,5,31,6,1,6,2,0,54,54,108,3,61,2.77777777777778,56.4814814814815,50,50
"232","44","4",0,2,3,1,1,19,14,0,2,2,18,13,2,12,0,0,42,50,92,0,37,0,40.2173913043478,54.3478260869565,45.6521739130435
"233","44","5",0,1,3,5,2,11,4,6,1,7,9,5,6,3,5,21,32,60,92,21,20,22.8260869565217,21.7391304347826,65.2173913043478,34.7826086956522
"234","44","6",0,1,0,2,0,2,0,7,1,1,3,5,2,6,8,46,14,73,87,46,5,52.8735632183908,5.74712643678161,83.9080459770115,16.0919540229885
"235","45","1",3,5,8,3,8,10,3,5,6,6,10,5,4,5,5,1,48,42,90,4,20,4.44444444444444,22.2222222222222,46.6666666666667,53.3333333333333
"236","45","2",9,6,8,4,10,6,3,2,6,6,7,2,2,3,2,0,49,30,79,9,13,11.3924050632911,16.4556962025316,37.9746835443038,62.0253164556962
"237","45","3",5,5,6,3,4,9,4,4,6,4,7,5,6,2,4,2,43,36,79,7,16,8.86075949367089,20.253164556962,45.5696202531646,54.4303797468354
"238","45","4",6,4,9,1,5,14,8,2,4,6,10,9,5,4,1,1,49,43,92,7,24,7.60869565217391,26.0869565217391,46.7391304347826,53.2608695652174
"239","45","5",0,0,1,1,1,9,3,4,0,2,9,6,1,5,3,8,19,37,56,8,18,14.2857142857143,32.1428571428571,66.0714285714286,33.9285714285714
"240","45","6",7,5,5,3,5,4,3,1,5,3,3,1,3,1,1,0,34,19,53,7,7,13.2075471698113,13.2075471698113,35.8490566037736,64.1509433962264
"241","46","1",3,4,1,4,2,4,1,9,4,1,6,6,3,7,9,6,30,43,73,9,10,12.3287671232877,13.6986301369863,58.9041095890411,41.0958904109589
"242","46","2",1,2,4,1,4,19,0,1,2,3,20,0,1,0,1,0,34,28,62,1,39,1.61290322580645,62.9032258064516,45.1612903225806,54.8387096774194
"243","46","3",0,0,0,0,0,10,0,0,0,0,11,0,0,0,0,0,12,12,24,0,21,0,87.5,50,50
"244","46","4",0,0,1,0,0,11,1,0,0,1,11,1,1,0,0,0,15,15,30,0,22,0,73.3333333333333,50,50
"245","46","5",0,0,1,0,1,17,2,1,0,1,17,3,0,3,1,0,23,27,50,0,34,0,68,54,46
"246","46","6",2,1,1,0,1,27,2,2,1,0,26,4,0,4,2,1,37,40,77,3,53,3.8961038961039,68.8311688311688,51.9480519480519,48.0519480519481
"247","47","1",3,3,3,4,3,8,4,8,3,3,8,8,3,9,8,25,37,69,106,28,16,26.4150943396226,15.0943396226415,65.0943396226415,34.9056603773585
"248","47","2",0,1,8,4,1,17,8,11,1,11,10,15,11,8,10,32,50,101,151,32,27,21.1920529801325,17.8807947019868,66.887417218543,33.112582781457
"249","47","3",0,0,5,6,5,12,6,8,0,10,13,8,5,9,8,6,44,60,104,6,25,5.76923076923077,24.0384615384615,57.6923076923077,42.3076923076923
"250","47","4",1,2,7,4,7,30,7,4,2,9,29,7,5,6,4,4,64,67,131,5,59,3.81679389312977,45.0381679389313,51.1450381679389,48.8549618320611
"251","47","5",25,13,13,5,15,5,3,3,13,6,7,1,3,3,3,0,84,37,121,25,12,20.6611570247934,9.91735537190083,30.5785123966942,69.4214876033058
"252","47","6",13,7,7,4,8,8,4,3,7,4,9,3,3,4,3,5,55,40,95,18,17,18.9473684210526,17.8947368421053,42.1052631578947,57.8947368421053
"253","48","1",8,6,8,4,8,16,8,3,6,7,16,7,5,7,4,3,63,56,119,11,32,9.2436974789916,26.890756302521,47.0588235294118,52.9411764705882
"254","48","2",10,9,9,5,6,8,6,7,10,5,5,8,9,4,7,5,63,53,116,15,13,12.9310344827586,11.2068965517241,45.6896551724138,54.3103448275862
"255","48","3",8,6,8,2,6,14,7,0,6,5,12,5,4,3,0,0,53,36,89,8,26,8.98876404494382,29.2134831460674,40.4494382022472,59.5505617977528
"256","48","4",0,0,7,4,5,16,12,0,0,12,14,7,7,5,0,0,46,46,92,0,30,0,32.6086956521739,50,50
"257","48","5",0,0,4,1,2,10,6,1,0,5,7,6,3,4,1,0,25,28,53,0,17,0,32.0754716981132,52.8301886792453,47.1698113207547
"258","48","6",1,1,5,0,3,10,3,0,1,4,9,3,2,1,0,0,25,21,46,1,19,2.17391304347826,41.304347826087,45.6521739130435,54.3478260869565
"259","49","1",1,2,3,3,0,13,5,3,2,4,10,5,6,2,3,5,32,38,70,6,23,8.57142857142857,32.8571428571429,54.2857142857143,45.7142857142857
"260","49","2",2,1,3,3,4,8,4,3,0,5,9,5,1,6,3,2,29,33,62,4,17,6.45161290322581,27.4193548387097,53.2258064516129,46.7741935483871
"261","49","3",2,4,5,5,3,8,7,4,4,6,6,5,7,4,4,1,39,39,78,3,14,3.84615384615385,17.9487179487179,50,50
"262","49","4",10,5,6,5,6,3,2,4,4,6,3,2,4,2,4,0,42,27,69,10,6,14.4927536231884,8.69565217391304,39.1304347826087,60.8695652173913
"263","49","5",0,1,1,5,3,5,4,4,1,5,8,3,3,6,4,6,25,37,62,6,13,9.67741935483871,20.9677419354839,59.6774193548387,40.3225806451613
"264","49","6",0,1,1,4,3,2,3,4,1,4,4,3,2,5,5,10,19,36,55,10,6,18.1818181818182,10.9090909090909,65.4545454545455,34.5454545454545
"265","5","1",5,4,4,7,6,11,7,4,4,6,13,5,4,7,4,5,49,50,99,10,24,10.1010101010101,24.2424242424242,50.5050505050505,49.4949494949495
"266","5","2",2,7,9,7,11,8,6,9,7,9,10,8,6,9,9,16,61,75,136,18,18,13.2352941176471,13.2352941176471,55.1470588235294,44.8529411764706
"267","5","3",16,9,8,7,11,3,3,6,9,6,6,2,4,5,6,6,66,44,110,22,9,20,8.18181818181818,40,60
"268","5","4",11,7,9,4,6,8,3,7,7,6,5,7,6,4,7,0,56,44,100,11,13,11,13,44,56
"269","5","5",4,6,5,7,7,8,9,5,5,6,10,7,4,9,5,1,52,49,101,5,18,4.95049504950495,17.8217821782178,48.5148514851485,51.4851485148515
"270","5","6",19,8,6,5,6,10,6,3,7,3,10,5,4,5,3,0,64,39,103,19,20,18.4466019417476,19.4174757281553,37.8640776699029,62.1359223300971
"271","50","1",3,4,7,3,8,12,6,3,5,6,13,6,3,6,3,5,49,47,96,8,25,8.33333333333333,26.0416666666667,48.9583333333333,51.0416666666667
"272","50","2",5,5,3,6,4,9,6,4,5,4,10,3,5,5,4,5,43,43,86,10,19,11.6279069767442,22.093023255814,50,50
"273","50","3",2,7,8,6,10,6,6,4,7,7,9,3,4,6,4,3,51,44,95,5,15,5.26315789473684,15.7894736842105,46.3157894736842,53.6842105263158
"274","50","4",12,10,12,3,11,5,4,2,10,6,4,3,4,2,2,0,61,32,93,12,9,12.9032258064516,9.67741935483871,34.4086021505376,65.5913978494624
"275","50","5",9,5,7,2,7,12,3,2,5,4,12,3,2,3,2,1,49,33,82,10,24,12.1951219512195,29.2682926829268,40.2439024390244,59.7560975609756
"276","50","6",5,2,6,1,4,17,4,0,2,5,15,4,3,1,0,0,40,32,72,5,32,6.94444444444444,44.4444444444444,44.4444444444444,55.5555555555556
"277","51","1",3,6,4,8,3,6,6,13,6,6,5,11,9,10,14,10,50,73,123,13,11,10.5691056910569,8.94308943089431,59.349593495935,40.650406504065
"278","51","2",2,2,2,8,2,2,7,13,2,8,2,12,9,12,14,32,40,92,132,34,4,25.7575757575758,3.03030303030303,69.6969696969697,30.3030303030303
"279","51","3",4,4,4,4,5,14,5,2,3,4,15,3,2,5,2,0,43,36,79,4,29,5.06329113924051,36.7088607594937,45.5696202531646,54.4303797468354
"280","51","4",3,5,3,4,4,8,3,2,6,2,8,1,4,1,2,3,35,27,62,6,16,9.67741935483871,25.8064516129032,43.5483870967742,56.4516129032258
"281","51","5",1,1,3,2,2,16,4,14,1,4,14,16,3,14,13,45,43,113,156,46,30,29.4871794871795,19.2307692307692,72.4358974358974,27.5641025641026
"282","51","6",0,2,1,3,1,4,2,10,2,2,4,10,3,10,10,44,24,87,111,44,8,39.6396396396396,7.20720720720721,78.3783783783784,21.6216216216216
"283","52","1",5,6,9,2,5,19,5,6,6,5,16,9,6,6,6,6,59,61,120,11,35,9.16666666666667,29.1666666666667,50.8333333333333,49.1666666666667
"284","52","2",1,11,11,11,16,38,9,12,11,10,43,11,5,16,12,10,110,120,230,11,81,4.78260869565217,35.2173913043478,52.1739130434783,47.8260869565217
"285","52","3",2,7,10,10,12,46,12,11,7,13,48,13,8,15,12,6,111,124,235,8,94,3.40425531914894,40,52.7659574468085,47.2340425531915
"286","52","4",5,8,4,7,5,5,7,4,8,3,6,4,6,5,4,9,47,46,93,14,11,15.0537634408602,11.8279569892473,49.4623655913978,50.5376344086022
"287","52","5",5,7,8,4,8,4,4,2,7,4,4,2,3,2,1,3,42,29,71,8,8,11.2676056338028,11.2676056338028,40.8450704225352,59.1549295774648
"288","52","6",9,3,5,1,3,6,1,4,4,3,4,3,4,1,4,3,35,26,61,12,10,19.672131147541,16.3934426229508,42.6229508196721,57.3770491803279
"289","53","1",5,6,9,6,7,31,6,9,6,9,29,9,7,7,8,12,79,90,169,17,60,10.0591715976331,35.5029585798817,53.2544378698225,46.7455621301775
"290","53","2",15,8,9,7,6,14,10,8,9,8,11,11,10,8,8,6,80,71,151,21,25,13.9072847682119,16.5562913907285,47.0198675496689,52.9801324503311
"291","53","3",14,8,12,5,7,12,8,5,8,9,7,8,10,3,5,11,72,63,135,25,19,18.5185185185185,14.0740740740741,46.6666666666667,53.3333333333333
"292","53","4",14,8,12,6,11,33,7,4,8,9,32,5,6,5,4,1,96,72,168,15,65,8.92857142857143,38.6904761904762,42.8571428571429,57.1428571428571
"293","53","5",4,5,4,6,5,20,5,9,5,5,20,8,5,8,8,5,58,67,125,9,40,7.2,32,53.6,46.4
"294","53","6",0,1,1,4,2,6,7,2,1,4,7,6,3,7,3,4,24,37,61,4,13,6.55737704918033,21.3114754098361,60.655737704918,39.344262295082
"295","54","1",2,4,4,5,4,8,5,8,4,5,8,7,5,7,8,7,41,53,94,9,16,9.57446808510638,17.0212765957447,56.3829787234043,43.6170212765957
"296","54","2",13,9,8,4,8,7,3,5,9,3,8,4,4,5,5,8,59,47,106,21,15,19.811320754717,14.1509433962264,44.3396226415094,55.6603773584906
"297","54","3",2,4,2,5,3,4,5,9,4,3,5,9,5,10,9,7,36,53,89,9,9,10.1123595505618,10.1123595505618,59.5505617977528,40.4494382022472
"298","54","4",4,3,6,1,5,9,8,3,3,4,8,10,2,9,3,8,40,49,89,12,17,13.4831460674157,19.1011235955056,55.0561797752809,44.9438202247191
"299","54","5",1,3,2,6,2,9,5,7,3,5,8,7,6,6,7,8,36,52,88,9,17,10.2272727272727,19.3181818181818,59.0909090909091,40.9090909090909
"300","54","6",0,0,0,1,0,7,4,9,0,1,7,13,1,13,10,11,22,58,80,11,14,13.75,17.5,72.5,27.5
"301","55","1",11,6,8,6,10,8,8,4,6,8,10,6,4,8,3,3,61,51,112,14,18,12.5,16.0714285714286,45.5357142857143,54.4642857142857
"302","55","2",19,14,10,9,10,5,5,9,14,5,4,5,9,5,9,10,82,63,145,29,9,20,6.20689655172414,43.448275862069,56.551724137931
"303","55","3",28,10,12,3,10,13,6,2,11,5,10,5,6,2,2,1,87,42,129,29,23,22.4806201550388,17.8294573643411,32.5581395348837,67.4418604651163
"304","55","4",32,13,12,5,14,13,5,2,13,4,15,2,3,4,2,2,98,46,144,34,28,23.6111111111111,19.4444444444444,31.9444444444444,68.0555555555556
"305","55","5",11,7,9,2,8,30,4,2,7,4,30,4,3,3,2,0,75,54,129,11,60,8.52713178294574,46.5116279069767,41.8604651162791,58.1395348837209
"306","55","6",3,3,7,1,4,60,5,1,3,5,57,5,4,2,1,1,85,80,165,4,117,2.42424242424242,70.9090909090909,48.4848484848485,51.5151515151515
"307","56","1",0,7,11,8,9,66,8,10,7,12,64,10,10,8,10,5,120,128,248,5,130,2.01612903225806,52.4193548387097,51.6129032258064,48.3870967741936
"308","56","2",2,15,18,8,22,371,9,10,15,12,375,11,4,15,10,0,457,443,900,2,746,0.222222222222222,82.8888888888889,49.2222222222222,50.7777777777778
"309","56","3",0,3,8,2,7,141,10,3,3,7,139,11,3,9,3,0,175,177,352,0,280,0,79.5454545454545,50.2840909090909,49.7159090909091
"310","56","4",0,0,3,1,3,43,3,0,0,4,44,2,1,2,0,0,55,54,109,0,87,0,79.8165137614679,49.5412844036697,50.4587155963303
"311","56","5",0,3,7,1,6,28,2,1,3,5,26,2,2,1,1,0,49,42,91,0,54,0,59.3406593406593,46.1538461538462,53.8461538461538
"312","56","6",0,2,3,1,2,29,3,1,2,2,29,3,2,2,1,0,43,42,85,0,58,0,68.2352941176471,49.4117647058824,50.5882352941176
"313","57","1",6,5,5,7,6,6,7,6,4,8,7,6,6,7,6,14,50,59,109,20,13,18.348623853211,11.9266055045872,54.1284403669725,45.8715596330275
"314","57","2",1,4,8,3,6,13,7,7,4,7,12,11,5,10,7,9,51,66,117,10,25,8.54700854700855,21.3675213675214,56.4102564102564,43.5897435897436
"315","57","3",8,6,3,8,3,4,5,9,5,5,4,6,7,7,9,2,47,47,94,10,8,10.6382978723404,8.51063829787234,50,50
"316","57","4",0,1,7,0,5,19,4,1,1,6,17,4,2,3,1,0,38,36,74,0,36,0,48.6486486486486,48.6486486486486,51.3513513513514
"317","57","5",0,0,3,0,3,26,2,0,1,3,25,2,1,1,0,0,37,33,70,0,51,0,72.8571428571429,47.1428571428571,52.8571428571429
"318","57","6",0,0,6,0,6,20,0,0,0,6,20,0,0,0,0,0,34,27,61,0,40,0,65.5737704918033,44.2622950819672,55.7377049180328
"319","58","1",2,4,2,6,2,1,4,4,3,4,1,3,5,3,4,4,26,29,55,6,2,10.9090909090909,3.63636363636364,52.7272727272727,47.2727272727273
"320","58","2",2,3,9,2,7,10,4,5,3,7,8,7,3,5,5,4,43,44,87,6,18,6.89655172413793,20.6896551724138,50.5747126436782,49.4252873563218
"321","58","3",11,4,11,4,11,10,2,4,4,11,11,2,4,2,4,4,59,43,102,15,21,14.7058823529412,20.5882352941176,42.156862745098,57.843137254902
"322","58","4",3,2,2,0,3,15,0,1,3,0,16,1,0,1,1,1,29,23,52,4,31,7.69230769230769,59.6153846153846,44.2307692307692,55.7692307692308
"323","58","5",7,5,4,3,5,3,3,0,5,2,4,0,2,1,0,0,33,14,47,7,7,14.8936170212766,14.8936170212766,29.7872340425532,70.2127659574468
"324","58","6",6,4,5,0,5,2,1,1,4,1,2,2,0,2,1,1,25,15,40,7,4,17.5,10,37.5,62.5
"325","59","1",1,3,4,7,7,4,7,7,3,8,7,7,5,9,7,9,42,56,98,10,11,10.2040816326531,11.2244897959184,57.1428571428571,42.8571428571429
"326","59","2",3,3,3,5,5,3,4,4,3,5,6,3,3,6,4,8,32,39,71,11,9,15.4929577464789,12.6760563380282,54.9295774647887,45.0704225352113
"327","59","3",0,2,3,2,3,7,3,3,2,3,7,5,2,5,4,4,24,34,58,4,14,6.89655172413793,24.1379310344828,58.6206896551724,41.3793103448276
"328","59","4",0,0,0,0,0,0,0,0,0,0,0,0,0,0,0,0,0,0,0,0,0,NA,NA,NA,NA
"329","59","5",0,0,0,0,0,0,0,0,0,0,0,0,0,0,0,0,0,0,0,0,0,NA,NA,NA,NA
"330","59","6",0,0,0,0,0,0,0,0,0,0,0,0,0,0,0,0,0,0,0,0,0,NA,NA,NA,NA
"331","6","1",5,9,2,10,7,3,2,9,9,3,8,1,5,6,9,6,47,50,97,11,11,11.340206185567,11.340206185567,51.5463917525773,48.4536082474227
"332","6","2",43,16,16,7,18,9,8,0,16,7,10,2,5,3,0,0,118,45,163,43,19,26.3803680981595,11.6564417177914,27.6073619631902,72.3926380368098
"333","6","3",15,6,7,8,8,9,10,3,5,9,11,5,6,7,3,2,68,49,117,17,20,14.5299145299145,17.0940170940171,41.8803418803419,58.1196581196581
"334","6","4",37,15,22,6,20,13,9,1,14,13,11,4,8,2,1,0,125,54,179,37,24,20.6703910614525,13.4078212290503,30.1675977653631,69.8324022346369
"335","6","5",41,17,14,7,12,6,4,5,16,4,4,2,9,0,5,3,108,44,152,44,10,28.9473684210526,6.57894736842105,28.9473684210526,71.0526315789474
"336","6","6",37,17,17,5,14,8,5,3,16,5,5,3,7,0,2,0,106,41,147,37,13,25.1700680272109,8.84353741496599,27.891156462585,72.108843537415
"337","60","1",0,2,3,6,5,11,7,8,2,7,13,9,4,10,8,5,43,60,103,5,24,4.85436893203883,23.3009708737864,58.252427184466,41.747572815534
"338","60","2",1,1,2,1,2,40,11,1,1,2,40,11,1,10,0,0,59,68,127,1,80,0.78740157480315,62.992125984252,53.5433070866142,46.4566929133858
"339","60","3",0,0,2,0,2,75,2,1,0,2,76,2,0,3,1,1,84,86,170,1,151,0.588235294117647,88.8235294117647,50.5882352941176,49.4117647058824
"340","60","4",0,0,1,0,1,68,1,0,0,1,69,1,0,1,0,0,73,73,146,0,137,0,93.8356164383562,50,50
"341","60","5",0,0,0,0,0,65,0,0,0,0,66,0,0,0,0,0,67,67,134,0,131,0,97.7611940298507,50,50
"342","60","6",0,0,1,1,0,54,4,1,0,2,54,4,2,3,1,0,63,67,130,0,108,0,83.0769230769231,51.5384615384615,48.4615384615385
"343","61","1",0,0,3,5,3,11,6,4,0,9,11,5,6,4,4,4,34,44,78,4,22,5.12820512820513,28.2051282051282,56.4102564102564,43.5897435897436
"344","61","2",2,3,4,3,4,13,6,0,3,4,12,3,3,3,0,0,36,30,66,2,25,3.03030303030303,37.8787878787879,45.4545454545455,54.5454545454545
"345","61","3",3,4,6,1,1,11,5,1,4,3,7,5,5,1,1,0,34,27,61,3,18,4.91803278688525,29.5081967213115,44.2622950819672,55.7377049180328
"346","61","4",25,6,5,4,6,5,2,3,5,3,6,1,3,2,3,1,58,25,83,26,11,31.3253012048193,13.2530120481928,30.1204819277108,69.8795180722892
"347","61","5",9,6,9,3,8,8,5,0,6,6,7,2,4,0,0,0,49,27,76,9,15,11.8421052631579,19.7368421052632,35.5263157894737,64.4736842105263
"348","61","6",11,6,9,2,9,10,4,1,5,6,10,3,2,3,1,1,54,32,86,12,20,13.953488372093,23.2558139534884,37.2093023255814,62.7906976744186
"349","62","1",1,5,4,4,3,5,4,3,4,3,4,3,5,2,3,6,31,31,62,7,9,11.2903225806452,14.5161290322581,50,50
"350","62","2",3,6,3,6,5,2,4,6,6,3,4,5,4,7,6,4,36,41,77,7,6,9.09090909090909,7.79220779220779,53.2467532467532,46.7532467532468
"351","62","3",0,2,1,4,2,3,3,10,2,3,4,8,3,9,9,14,25,55,80,14,7,17.5,8.75,68.75,31.25
"352","62","4",7,6,6,3,5,1,1,3,7,2,0,1,4,0,3,1,35,18,53,8,1,15.0943396226415,1.88679245283019,33.9622641509434,66.0377358490566
"353","62","5",2,5,2,5,4,4,6,3,5,2,6,4,3,6,2,0,31,31,62,2,10,3.2258064516129,16.1290322580645,50,50
"354","62","6",6,5,3,7,5,1,6,1,6,4,3,0,5,2,1,2,37,23,60,8,4,13.3333333333333,6.66666666666667,38.3333333333333,61.6666666666667
"355","63","1",0,1,2,0,1,3,1,1,1,1,2,2,0,1,0,2,9,12,21,2,5,9.52380952380952,23.8095238095238,57.1428571428571,42.8571428571429
"356","63","2",0,0,0,0,0,0,0,0,0,0,0,0,1,0,1,0,2,3,5,0,0,0,0,60,40
"357","63","3",0,0,1,0,0,1,0,0,0,1,0,0,0,0,0,0,3,3,6,0,1,0,16.6666666666667,50,50
"358","63","4",0,1,1,0,2,1,0,0,1,1,1,0,0,0,0,0,7,4,11,0,2,0,18.1818181818182,36.3636363636364,63.6363636363636
"359","63","5",0,0,0,0,0,0,0,0,0,0,0,0,0,0,0,0,0,0,0,0,0,NA,NA,NA,NA
"360","63","6",0,0,0,0,0,0,0,0,0,0,0,0,0,0,0,0,0,0,0,0,0,NA,NA,NA,NA
"361","64","1",0,4,4,4,1,12,4,8,4,4,9,8,7,5,8,16,40,61,101,16,21,15.8415841584158,20.7920792079208,60.3960396039604,39.6039603960396
"362","64","2",2,1,1,3,2,16,2,4,1,3,18,3,2,4,4,3,33,39,72,5,34,6.94444444444444,47.2222222222222,54.1666666666667,45.8333333333333
"363","64","3",0,0,1,1,1,8,2,0,0,2,9,1,0,2,0,0,15,15,30,0,17,0,56.6666666666667,50,50
"364","64","4",0,4,2,4,4,0,4,3,4,3,2,3,3,4,3,6,23,29,52,6,2,11.5384615384615,3.84615384615385,55.7692307692308,44.2307692307692
"365","64","5",0,0,0,3,1,2,2,6,0,3,2,5,2,5,6,20,15,45,60,20,4,33.3333333333333,6.66666666666667,75,25
"366","64","6",3,4,1,4,2,3,6,3,4,1,4,5,3,7,4,4,27,34,61,7,7,11.4754098360656,11.4754098360656,55.7377049180328,44.2622950819672
"367","65","1",8,4,2,4,3,4,7,4,4,2,5,7,2,8,3,5,36,39,75,13,9,17.3333333333333,12,52,48
"368","65","2",9,10,10,7,5,10,8,10,10,6,6,11,11,7,10,13,71,75,146,22,16,15.0684931506849,10.958904109589,51.3698630136986,48.6301369863014
"369","65","3",25,7,8,4,8,9,8,3,7,5,10,7,3,8,3,5,74,49,123,30,19,24.390243902439,15.4471544715447,39.8373983739837,60.1626016260163
"370","65","4",42,13,9,8,6,7,6,7,12,4,4,5,11,2,7,11,100,57,157,53,11,33.7579617834395,7.00636942675159,36.3057324840764,63.6942675159236
"371","65","5",42,11,18,2,18,13,4,1,12,9,13,3,3,3,1,0,112,44,156,42,26,26.9230769230769,16.6666666666667,28.2051282051282,71.7948717948718
"372","65","6",17,8,6,4,6,8,4,2,7,2,8,3,3,3,2,0,56,30,86,17,16,19.7674418604651,18.6046511627907,34.8837209302326,65.1162790697674
"373","66","1",7,2,4,1,4,9,7,5,2,3,9,11,1,11,5,6,40,50,90,13,18,14.4444444444444,20,55.5555555555556,44.4444444444444
"374","66","2",1,5,5,6,6,21,8,4,5,5,22,6,4,8,4,2,57,58,115,3,43,2.60869565217391,37.3913043478261,50.4347826086956,49.5652173913044
"375","66","3",3,5,6,7,9,8,8,7,5,9,10,8,5,10,7,8,55,63,118,11,18,9.32203389830508,15.2542372881356,53.3898305084746,46.6101694915254
"376","66","4",0,0,2,1,1,19,3,10,0,3,18,12,2,11,10,25,37,83,120,25,37,20.8333333333333,30.8333333333333,69.1666666666667,30.8333333333333
"377","66","5",1,1,1,2,3,27,3,5,1,2,28,7,0,8,5,6,44,59,103,7,55,6.79611650485437,53.3980582524272,57.2815533980583,42.7184466019417
"378","66","6",0,2,2,2,1,7,4,11,2,1,7,13,2,13,11,10,31,60,91,10,14,10.989010989011,15.3846153846154,65.9340659340659,34.0659340659341
"379","67","1",4,2,1,3,3,14,4,3,2,2,16,3,1,5,3,2,35,36,71,6,30,8.45070422535211,42.2535211267606,50.7042253521127,49.2957746478873
"380","67","2",0,3,0,4,0,5,4,9,3,1,5,9,4,9,9,19,26,61,87,19,10,21.8390804597701,11.4942528735632,70.1149425287356,29.8850574712644
"381","67","3",6,4,4,5,6,2,6,4,4,5,4,4,4,6,4,3,39,35,74,9,6,12.1621621621622,8.10810810810811,47.2972972972973,52.7027027027027
"382","67","4",0,0,1,1,0,3,0,5,0,2,3,4,2,4,6,34,12,56,68,34,6,50,8.82352941176471,82.3529411764706,17.6470588235294
"383","67","5",0,0,1,1,0,1,3,5,0,2,0,6,2,5,4,23,11,45,56,23,1,41.0714285714286,1.78571428571429,80.3571428571429,19.6428571428571
"384","67","6",0,0,2,1,1,8,0,7,0,3,7,6,1,5,6,5,19,36,55,5,15,9.09090909090909,27.2727272727273,65.4545454545455,34.5454545454545
"385","68","1",2,2,3,6,7,26,7,0,2,7,30,1,2,5,0,0,54,49,103,2,56,1.94174757281553,54.3689320388349,47.5728155339806,52.4271844660194
"386","68","2",0,0,2,1,3,176,5,2,0,3,177,6,0,7,2,0,191,196,387,0,353,0,91.2144702842377,50.6459948320413,49.3540051679587
"387","68","3",0,0,1,1,2,369,2,0,0,2,371,1,0,2,0,0,377,377,754,0,740,0,98.1432360742706,50,50
"388","68","4",0,0,0,0,0,348,0,0,0,0,349,0,0,0,0,0,350,350,700,0,697,0,99.5714285714286,50,50
"389","68","5",0,0,0,0,0,384,0,0,0,0,385,0,0,0,0,0,386,386,772,0,769,0,99.6113989637306,50,50
"390","68","6",0,1,2,0,2,291,1,4,1,1,291,5,0,5,4,8,302,317,619,8,582,1.2924071082391,94.0226171243942,51.2116316639742,48.7883683360258
"391","69","1",2,6,8,6,8,14,10,8,6,8,14,11,6,12,8,10,63,77,140,12,28,8.57142857142857,20,55,45
"392","69","2",3,6,11,4,8,12,10,10,6,10,9,16,8,13,11,7,66,81,147,10,21,6.80272108843537,14.2857142857143,55.1020408163265,44.8979591836735
"393","69","3",2,8,7,6,6,23,13,3,8,5,22,10,7,9,3,0,69,66,135,2,45,1.48148148148148,33.3333333333333,48.8888888888889,51.1111111111111
"394","69","4",16,9,8,8,11,6,10,2,9,7,9,4,5,7,2,1,71,46,117,17,15,14.5299145299145,12.8205128205128,39.3162393162393,60.6837606837607
"395","69","5",2,6,8,5,6,12,10,4,6,7,10,9,7,6,4,1,54,52,106,3,22,2.83018867924528,20.7547169811321,49.0566037735849,50.9433962264151
"396","69","6",9,5,4,4,5,10,4,6,5,3,12,6,3,7,6,6,49,49,98,15,22,15.3061224489796,22.4489795918367,50,50
"397","7","1",4,3,5,7,7,16,10,5,3,9,19,8,4,11,5,2,59,62,121,6,35,4.95867768595041,28.9256198347107,51.2396694214876,48.7603305785124
"398","7","2",0,1,2,8,1,18,7,12,1,9,17,10,9,10,12,29,50,99,149,29,35,19.4630872483221,23.489932885906,66.4429530201342,33.5570469798658
"399","7","3",0,0,1,3,1,3,5,15,0,4,3,17,3,17,14,16,28,77,105,16,6,15.2380952380952,5.71428571428571,73.3333333333333,26.6666666666667
"400","7","4",2,3,3,3,2,6,1,12,2,3,5,11,3,10,12,34,33,82,115,36,11,31.304347826087,9.56521739130435,71.304347826087,28.695652173913
"401","7","5",0,1,2,4,4,3,2,7,1,4,5,6,1,8,7,20,24,54,78,20,8,25.6410256410256,10.2564102564103,69.2307692307692,30.7692307692308
"402","7","6",2,3,2,4,2,10,4,6,3,3,10,6,3,6,5,8,33,47,80,10,20,12.5,25,58.75,41.25
"403","70","1",4,4,7,3,8,14,3,3,3,6,16,3,1,5,3,3,48,41,89,7,30,7.86516853932584,33.7078651685393,46.0674157303371,53.9325842696629
"404","70","2",9,7,9,2,6,8,3,4,7,4,5,5,5,2,4,5,49,39,88,14,13,15.9090909090909,14.7727272727273,44.3181818181818,55.6818181818182
"405","70","3",7,4,6,3,6,8,6,4,4,5,8,7,3,7,4,5,46,44,90,12,16,13.3333333333333,17.7777777777778,48.8888888888889,51.1111111111111
"406","70","4",8,7,10,5,9,3,5,3,7,8,2,3,6,2,4,1,51,35,86,9,5,10.4651162790698,5.81395348837209,40.6976744186046,59.3023255813954
"407","70","5",1,4,3,5,3,8,9,4,3,4,8,8,4,8,4,5,38,46,84,6,16,7.14285714285714,19.047619047619,54.7619047619048,45.2380952380952
"408","70","6",1,2,4,2,1,14,10,2,2,4,11,10,5,7,2,0,38,42,80,1,25,1.25,31.25,52.5,47.5
"409","71","1",4,3,2,5,6,9,4,5,4,4,13,4,2,8,5,5,41,45,86,9,22,10.4651162790698,25.5813953488372,52.3255813953488,47.6744186046512
"410","71","2",2,1,2,3,5,27,6,1,1,4,30,4,1,6,1,2,49,50,99,4,57,4.04040404040404,57.5757575757576,50.5050505050505,49.4949494949495
"411","71","3",2,3,2,5,3,15,5,7,3,4,16,7,4,7,7,2,43,52,95,4,31,4.21052631578947,32.6315789473684,54.7368421052632,45.2631578947368
"412","71","4",7,2,3,2,5,9,2,3,2,3,10,3,0,4,2,1,33,28,61,8,19,13.1147540983607,31.1475409836066,45.9016393442623,54.0983606557377
"413","71","5",0,0,1,0,0,10,1,1,0,1,8,3,1,1,1,1,14,18,32,1,18,3.125,56.25,56.25,43.75
"414","71","6",0,0,0,0,0,0,0,0,0,0,0,0,0,1,0,0,1,3,4,0,0,0,0,75,25
"415","72","1",5,7,8,6,8,5,3,8,7,7,5,5,6,5,7,9,50,54,104,14,10,13.4615384615385,9.61538461538461,51.9230769230769,48.0769230769231
"416","72","2",0,0,2,3,2,9,7,8,0,5,9,11,3,12,8,8,32,58,90,8,18,8.88888888888889,20,64.4444444444444,35.5555555555556
"417","72","3",0,1,1,1,1,4,0,7,1,1,4,6,1,6,7,32,15,61,76,32,8,42.1052631578947,10.5263157894737,80.2631578947368,19.7368421052632
"418","72","4",0,0,1,1,0,4,2,7,0,2,3,8,2,7,7,14,15,46,61,14,7,22.9508196721311,11.4754098360656,75.4098360655738,24.5901639344262
"419","72","5",0,0,0,0,0,1,3,3,0,0,1,6,0,6,3,19,7,38,45,19,2,42.2222222222222,4.44444444444444,84.4444444444444,15.5555555555556
"420","72","6",0,0,1,1,0,1,1,3,0,2,1,3,2,3,4,16,9,32,41,16,2,39.0243902439024,4.8780487804878,78.0487804878049,21.9512195121951
"421","73","1",3,4,4,1,4,18,1,2,4,1,18,2,0,3,2,2,38,34,72,5,36,6.94444444444444,50,47.2222222222222,52.7777777777778
"422","73","2",2,5,4,4,4,12,5,3,4,3,13,4,3,5,3,1,41,37,78,3,25,3.84615384615385,32.0512820512821,47.4358974358974,52.5641025641026
"423","73","3",7,4,3,2,3,2,4,1,4,1,3,3,2,4,1,9,28,28,56,16,5,28.5714285714286,8.92857142857143,50,50
"424","73","4",1,1,2,0,1,6,1,1,1,1,5,2,1,2,1,4,14,19,33,5,11,15.1515151515152,33.3333333333333,57.5757575757576,42.4242424242424
"425","73","5",0,2,3,1,3,3,2,2,2,2,3,2,1,2,1,2,16,18,34,2,6,5.88235294117647,17.6470588235294,52.9411764705882,47.0588235294118
"426","73","6",0,0,0,0,0,4,1,3,0,0,5,3,0,4,3,2,10,18,28,2,9,7.14285714285714,32.1428571428571,64.2857142857143,35.7142857142857
"427","74","1",5,3,2,6,2,8,6,3,3,5,8,4,5,4,3,3,36,37,73,8,16,10.958904109589,21.9178082191781,50.6849315068493,49.3150684931507
"428","74","2",13,9,9,6,8,41,11,6,8,6,41,11,6,11,6,0,105,90,195,13,82,6.66666666666667,42.0512820512821,46.1538461538462,53.8461538461538
"429","74","3",1,9,12,5,14,118,5,7,9,8,120,7,3,8,7,0,172,164,336,1,238,0.297619047619048,70.8333333333333,48.8095238095238,51.1904761904762
"430","74","4",0,2,3,0,1,3,1,2,1,2,1,3,2,1,2,8,14,21,35,8,4,22.8571428571429,11.4285714285714,60,40
"431","74","5",0,0,3,4,4,6,6,1,0,7,7,3,3,5,2,0,25,29,54,0,13,0,24.0740740740741,53.7037037037037,46.2962962962963
"432","74","6",0,0,1,0,0,12,1,3,0,1,12,3,1,3,3,2,19,26,45,2,24,4.44444444444444,53.3333333333333,57.7777777777778,42.2222222222222
"433","75","1",6,4,2,4,3,7,6,4,5,2,8,6,4,7,4,7,39,43,82,13,15,15.8536585365854,18.2926829268293,52.4390243902439,47.5609756097561
"434","75","2",0,1,6,3,5,7,11,4,1,8,6,12,4,11,3,4,37,52,89,4,13,4.49438202247191,14.6067415730337,58.4269662921348,41.5730337078652
"435","75","3",0,1,3,0,2,18,2,2,1,2,18,4,0,4,2,2,30,34,64,2,36,3.125,56.25,53.125,46.875
"436","75","4",0,0,3,2,2,12,5,5,0,5,11,8,3,6,5,12,30,52,82,12,23,14.6341463414634,28.0487804878049,63.4146341463415,36.5853658536585
"437","75","5",0,0,2,2,2,15,3,2,0,3,15,3,1,3,2,3,27,32,59,3,30,5.08474576271186,50.8474576271186,54.2372881355932,45.7627118644068
"438","75","6",2,1,0,2,1,8,1,7,1,1,9,7,1,7,7,8,23,43,66,10,17,15.1515151515152,25.7575757575758,65.1515151515152,34.8484848484849
"439","76","1",5,2,2,4,1,4,6,7,2,4,3,8,5,7,7,6,32,44,76,11,7,14.4736842105263,9.21052631578947,57.8947368421053,42.1052631578947
"440","76","2",0,1,3,5,4,9,6,5,1,7,10,6,4,7,5,3,33,46,79,3,19,3.79746835443038,24.0506329113924,58.2278481012658,41.7721518987342
"441","76","3",4,2,3,3,4,12,11,0,2,4,12,9,2,9,0,0,40,40,80,4,24,5,30,50,50
"442","76","4",1,1,3,6,4,1,3,5,1,7,2,2,4,3,4,12,24,38,62,13,3,20.9677419354839,4.83870967741935,61.2903225806452,38.7096774193548
"443","76","5",2,7,3,6,3,1,4,3,7,2,1,1,5,1,3,3,30,25,55,5,2,9.09090909090909,3.63636363636364,45.4545454545455,54.5454545454545
"444","76","6",3,1,4,2,3,2,0,3,2,4,1,1,3,0,3,4,21,18,39,7,3,17.9487179487179,7.69230769230769,46.1538461538462,53.8461538461538
"445","77","1",3,6,4,3,3,7,3,4,6,1,6,5,4,3,4,2,34,33,67,5,13,7.46268656716418,19.4029850746269,49.2537313432836,50.7462686567164
"446","77","2",3,4,5,9,6,6,11,4,4,10,6,7,8,7,4,7,49,55,104,10,12,9.61538461538461,11.5384615384615,52.8846153846154,47.1153846153846
"447","77","3",7,5,6,2,3,11,7,2,5,3,9,7,5,5,2,5,45,42,87,12,20,13.7931034482759,22.9885057471264,48.2758620689655,51.7241379310345
"448","77","4",6,4,4,5,4,4,4,8,4,5,3,7,5,6,7,1,39,41,80,7,7,8.75,8.75,51.25,48.75
"449","77","5",0,1,5,1,4,6,3,2,1,5,5,4,3,3,3,5,24,30,54,5,11,9.25925925925926,20.3703703703704,55.5555555555556,44.4444444444444
"450","77","6",0,2,1,2,2,4,2,6,2,2,5,5,2,6,6,8,21,37,58,8,9,13.7931034482759,15.5172413793103,63.7931034482759,36.2068965517241
"451","78","1",3,3,6,6,4,5,8,4,3,9,4,5,8,4,4,3,41,41,82,6,9,7.31707317073171,10.9756097560976,50,50
"452","78","2",4,8,11,3,12,7,3,2,7,6,9,2,1,4,2,1,52,33,85,5,16,5.88235294117647,18.8235294117647,38.8235294117647,61.1764705882353
"453","78","3",5,5,7,2,5,18,3,4,5,5,15,5,5,2,4,10,51,52,103,15,33,14.5631067961165,32.0388349514563,50.4854368932039,49.5145631067961
"454","78","4",1,1,4,2,1,47,5,1,1,5,43,4,5,1,1,1,63,63,126,2,90,1.58730158730159,71.4285714285714,50,50
"455","78","5",2,2,2,2,4,30,2,0,2,2,31,0,0,2,0,0,45,39,84,2,61,2.38095238095238,72.6190476190476,46.4285714285714,53.5714285714286
"456","78","6",1,1,2,0,1,31,1,0,1,1,29,1,1,0,0,0,38,35,73,1,60,1.36986301369863,82.1917808219178,47.9452054794521,52.0547945205479
"457","79","1",9,8,8,4,10,6,5,6,8,5,8,6,3,8,6,2,58,47,105,11,14,10.4761904761905,13.3333333333333,44.7619047619048,55.2380952380952
"458","79","2",5,6,9,2,9,16,5,3,6,5,17,5,2,6,3,0,57,45,102,5,33,4.90196078431373,32.3529411764706,44.1176470588235,55.8823529411765
"459","79","3",3,5,2,6,2,2,8,4,5,3,1,6,6,5,3,2,32,34,66,5,3,7.57575757575758,4.54545454545455,51.5151515151515,48.4848484848485
"460","79","4",5,4,0,5,1,0,2,4,4,1,2,0,4,2,4,15,23,33,56,20,2,35.7142857142857,3.57142857142857,58.9285714285714,41.0714285714286
"461","79","5",4,3,4,2,4,2,3,3,3,3,2,4,2,4,3,5,27,27,54,9,4,16.6666666666667,7.40740740740741,50,50
"462","79","6",3,4,1,4,3,4,4,4,4,1,6,3,3,5,4,2,29,29,58,5,10,8.62068965517241,17.2413793103448,50,50
"463","8","1",1,1,2,2,2,8,1,4,1,3,9,2,2,3,4,7,23,32,55,8,17,14.5454545454545,30.9090909090909,58.1818181818182,41.8181818181818
"464","8","2",0,0,2,4,2,8,8,2,0,6,8,6,5,5,2,2,28,35,63,2,16,3.17460317460317,25.3968253968254,55.5555555555556,44.4444444444444
"465","8","3",0,0,2,9,2,5,12,3,0,11,5,5,9,5,3,2,34,42,76,2,10,2.63157894736842,13.1578947368421,55.2631578947368,44.7368421052632
"466","8","4",0,0,3,5,5,16,8,0,0,8,19,3,3,6,0,0,39,40,79,0,35,0,44.3037974683544,50.6329113924051,49.3670886075949
"467","8","5",2,1,2,4,2,5,5,0,1,5,6,1,4,1,0,0,23,19,42,2,11,4.76190476190476,26.1904761904762,45.2380952380952,54.7619047619048
"468","8","6",0,0,1,1,1,7,2,0,0,2,7,1,1,1,0,0,13,14,27,0,14,0,51.8518518518519,51.8518518518519,48.1481481481481
"469","80","1",4,4,8,7,10,3,10,6,4,11,5,10,4,12,6,1,53,55,108,5,8,4.62962962962963,7.40740740740741,50.9259259259259,49.0740740740741
"470","80","2",3,3,4,1,3,15,3,4,3,2,14,6,2,5,4,1,37,39,76,4,29,5.26315789473684,38.1578947368421,51.3157894736842,48.6842105263158
"471","80","3",3,4,7,1,6,11,2,2,4,4,9,3,2,2,2,0,37,28,65,3,20,4.61538461538461,30.7692307692308,43.0769230769231,56.9230769230769
"472","80","4",2,3,4,4,5,4,4,5,3,5,4,5,3,5,5,5,32,37,69,7,8,10.1449275362319,11.5942028985507,53.6231884057971,46.3768115942029
"473","80","5",14,5,3,6,4,1,6,3,5,4,2,3,6,3,3,1,44,28,72,15,3,20.8333333333333,4.16666666666667,38.8888888888889,61.1111111111111
"474","80","6",12,5,4,3,6,0,2,5,5,3,2,4,1,6,5,3,39,30,69,15,2,21.7391304347826,2.89855072463768,43.4782608695652,56.5217391304348
"475","81","1",2,1,3,1,2,3,3,1,1,3,2,3,2,1,0,1,16,16,32,3,5,9.375,15.625,50,50
"476","81","2",3,2,4,1,4,6,2,1,2,3,5,2,2,1,1,0,25,17,42,3,11,7.14285714285714,26.1904761904762,40.4761904761905,59.5238095238095
"477","81","3",0,0,1,1,1,3,1,2,0,2,2,2,1,2,2,6,10,19,29,6,5,20.6896551724138,17.2413793103448,65.5172413793103,34.4827586206897
"478","81","4",0,1,0,2,0,0,1,1,1,1,0,0,1,0,0,2,5,8,13,2,0,15.3846153846154,0,61.5384615384615,38.4615384615385
"479","81","5",0,1,0,1,0,0,1,1,1,0,0,0,1,0,1,0,5,5,10,0,0,0,0,50,50
"480","81","6",0,0,0,0,0,1,0,0,0,0,2,0,0,1,1,0,3,5,8,0,3,0,37.5,62.5,37.5
"481","82","1",0,1,1,3,2,4,1,3,1,3,4,1,2,2,3,3,16,21,37,3,8,8.10810810810811,21.6216216216216,56.7567567567568,43.2432432432432
"482","82","2",2,3,3,5,2,2,3,4,2,5,1,2,6,1,4,3,26,25,51,5,3,9.80392156862745,5.88235294117647,49.0196078431373,50.9803921568627
"483","82","3",3,1,0,2,1,0,3,1,1,1,1,2,0,3,1,1,12,12,24,4,1,16.6666666666667,4.16666666666667,50,50
"484","82","4",2,2,2,0,2,2,0,0,2,1,2,0,0,0,0,0,12,6,18,2,4,11.1111111111111,22.2222222222222,33.3333333333333,66.6666666666667
"485","82","5",1,2,2,2,2,0,2,0,1,2,0,0,1,0,0,0,12,6,18,1,0,5.55555555555556,0,33.3333333333333,66.6666666666667
"486","82","6",0,0,0,1,1,0,1,1,0,2,1,1,1,2,2,1,6,11,17,1,1,5.88235294117647,5.88235294117647,64.7058823529412,35.2941176470588
"487","83","1",11,2,3,3,4,4,2,2,2,4,4,1,2,2,2,2,32,21,53,13,8,24.5283018867925,15.0943396226415,39.622641509434,60.377358490566
"488","83","2",5,5,6,1,5,6,0,4,5,2,5,3,1,2,3,2,32,26,58,7,11,12.0689655172414,18.9655172413793,44.8275862068966,55.1724137931034
"489","83","3",3,2,0,2,1,4,3,3,2,0,5,3,1,5,3,3,19,24,43,6,9,13.953488372093,20.9302325581395,55.8139534883721,44.1860465116279
"490","83","4",2,1,1,1,1,12,3,4,1,1,11,6,1,6,4,4,26,36,62,6,23,9.67741935483871,37.0967741935484,58.0645161290323,41.9354838709677
"491","83","5",0,0,1,2,2,8,2,3,0,3,9,3,1,4,3,4,20,28,48,4,17,8.33333333333333,35.4166666666667,58.3333333333333,41.6666666666667
"492","83","6",0,0,1,0,0,4,1,2,0,1,3,3,1,2,2,8,9,22,31,8,7,25.8064516129032,22.5806451612903,70.9677419354839,29.0322580645161
"493","84","1",2,1,1,4,0,9,9,7,2,3,8,12,5,11,7,13,36,61,97,15,17,15.4639175257732,17.5257731958763,62.8865979381443,37.1134020618557
"494","84","2",5,4,2,9,5,2,5,5,5,7,5,1,7,4,5,3,40,37,77,8,7,10.3896103896104,9.09090909090909,48.0519480519481,51.9480519480519
"495","84","3",2,3,5,2,3,3,5,3,3,4,2,6,4,4,3,1,28,28,56,3,5,5.35714285714286,8.92857142857143,50,50
"496","84","4",1,2,3,4,4,4,1,5,2,6,5,2,4,3,6,3,26,32,58,4,9,6.89655172413793,15.5172413793103,55.1724137931034,44.8275862068966
"497","84","5",0,1,0,5,2,5,6,5,1,4,7,7,2,9,5,3,25,40,65,3,12,4.61538461538461,18.4615384615385,61.5384615384615,38.4615384615385
"498","84","6",3,2,3,2,3,4,2,3,2,3,4,3,2,3,3,5,22,28,50,8,8,16,16,56,44
"499","85","1",1,1,0,2,1,1,2,4,1,1,2,4,1,5,4,7,12,28,40,8,3,20,7.5,70,30
"500","85","2",0,0,1,0,0,5,0,2,0,1,5,2,0,2,2,8,10,21,31,8,10,25.8064516129032,32.258064516129,67.741935483871,32.258064516129
"501","85","3",0,1,0,1,0,4,1,3,1,0,4,4,1,4,4,6,11,26,37,6,8,16.2162162162162,21.6216216216216,70.2702702702703,29.7297297297297
"502","85","4",0,0,2,3,2,8,4,0,0,5,8,1,3,2,0,0,20,21,41,0,16,0,39.0243902439024,51.219512195122,48.780487804878
"503","85","5",1,1,4,0,1,8,2,0,1,3,6,2,2,0,0,0,19,15,34,1,14,2.94117647058824,41.1764705882353,44.1176470588235,55.8823529411765
"504","85","6",0,0,1,1,1,2,2,3,0,2,2,4,1,3,2,1,10,18,28,1,4,3.57142857142857,14.2857142857143,64.2857142857143,35.7142857142857
"505","86","1",6,6,6,3,4,8,4,5,6,4,6,6,5,4,5,7,44,44,88,13,14,14.7727272727273,15.9090909090909,50,50
"506","86","2",1,3,7,1,5,6,3,3,3,5,4,4,3,3,3,0,30,27,57,1,10,1.75438596491228,17.5438596491228,47.3684210526316,52.6315789473684
"507","86","3",3,3,6,2,5,7,3,1,3,5,6,2,2,2,1,0,31,23,54,3,13,5.55555555555556,24.0740740740741,42.5925925925926,57.4074074074074
"508","86","4",3,4,6,2,7,7,1,4,5,4,8,2,2,3,4,3,37,31,68,6,15,8.82352941176471,22.0588235294118,45.5882352941176,54.4117647058824
"509","86","5",17,9,7,3,7,5,4,1,9,1,5,2,3,2,1,1,55,25,80,18,10,22.5,12.5,31.25,68.75
"510","86","6",3,4,7,0,5,19,1,0,4,2,18,1,1,0,0,0,41,27,68,3,37,4.41176470588235,54.4117647058824,39.7058823529412,60.2941176470588
"511","87","1",0,5,7,4,8,3,4,4,5,5,4,4,2,5,4,2,36,33,69,2,7,2.89855072463768,10.1449275362319,47.8260869565217,52.1739130434783
"512","87","2",1,4,2,5,3,4,8,3,4,3,5,5,4,6,2,2,30,34,64,3,9,4.6875,14.0625,53.125,46.875
"513","87","3",2,2,5,2,5,4,1,5,2,5,4,3,3,3,5,2,28,28,56,4,8,7.14285714285714,14.2857142857143,50,50
"514","87","4",0,0,0,0,0,5,1,3,0,1,5,3,1,3,3,2,11,19,30,2,10,6.66666666666667,33.3333333333333,63.3333333333333,36.6666666666667
"515","87","5",0,0,2,1,2,3,3,3,0,4,3,4,2,4,3,4,16,25,41,4,6,9.75609756097561,14.6341463414634,60.9756097560976,39.0243902439024
"516","87","6",3,2,2,3,5,2,3,1,3,3,5,1,1,3,1,0,24,17,41,3,7,7.31707317073171,17.0731707317073,41.4634146341463,58.5365853658537
"517","88","1",0,0,0,0,0,0,0,1,0,0,0,0,0,1,1,0,2,4,6,0,0,0,0,66.6666666666667,33.3333333333333
"518","88","2",2,2,1,1,1,2,1,0,2,1,2,0,1,0,0,0,12,7,19,2,4,10.5263157894737,21.0526315789474,36.8421052631579,63.1578947368421
"519","88","3",1,1,2,0,1,2,0,0,1,0,2,0,0,0,0,0,9,4,13,1,4,7.69230769230769,30.7692307692308,30.7692307692308,69.2307692307692
"520","88","4",0,0,0,0,0,1,0,0,0,0,2,0,0,0,0,0,3,3,6,0,3,0,50,50,50
"521","88","5",0,1,2,0,2,2,0,0,1,1,2,1,0,0,0,0,8,7,15,0,4,0,26.6666666666667,46.6666666666667,53.3333333333333
"522","88","6",0,0,1,0,0,1,0,0,0,0,1,0,0,0,0,0,4,2,6,0,2,0,33.3333333333333,33.3333333333333,66.6666666666667
"523","89","1",2,3,4,1,4,11,3,0,2,3,11,2,1,2,0,0,30,22,52,2,22,3.84615384615385,42.3076923076923,42.3076923076923,57.6923076923077
"524","89","2",5,3,3,3,1,7,5,1,3,3,6,3,5,1,1,0,30,23,53,5,13,9.43396226415094,24.5283018867925,43.3962264150943,56.6037735849057
"525","89","3",0,1,0,1,1,6,1,6,1,1,7,6,1,6,6,8,18,37,55,8,13,14.5454545454545,23.6363636363636,67.2727272727273,32.7272727272727
"526","89","4",0,0,0,4,1,12,2,4,0,4,14,2,3,4,5,13,25,46,71,13,26,18.3098591549296,36.6197183098592,64.7887323943662,35.2112676056338
"527","89","5",0,1,1,5,1,7,6,3,1,5,7,4,5,3,2,2,24,32,56,2,14,3.57142857142857,25,57.1428571428571,42.8571428571429
"528","89","6",0,0,2,0,1,7,3,3,0,2,6,6,1,5,3,8,17,33,50,8,13,16,26,66,34
"529","9","1",2,4,9,4,9,10,6,6,4,9,10,8,4,9,7,5,51,58,109,7,20,6.42201834862385,18.348623853211,53.2110091743119,46.7889908256881
"530","9","2",1,2,9,2,9,15,3,2,3,9,14,3,3,2,2,2,46,38,84,3,29,3.57142857142857,34.5238095238095,45.2380952380952,54.7619047619048
"531","9","3",3,4,6,2,5,18,2,3,4,4,17,3,3,1,2,0,43,37,80,3,35,3.75,43.75,46.25,53.75
"532","9","4",0,0,2,1,0,7,1,1,0,2,5,1,2,0,1,4,13,17,30,4,12,13.3333333333333,40,56.6666666666667,43.3333333333333
"533","9","5",0,0,0,0,0,0,0,0,0,0,0,0,0,0,0,0,1,1,2,0,0,0,0,50,50
"534","9","6",0,0,0,1,1,3,2,1,0,1,4,1,0,3,1,1,9,13,22,1,7,4.54545454545455,31.8181818181818,59.0909090909091,40.9090909090909
"535","90","1",1,1,0,1,2,3,1,0,1,0,5,0,0,1,0,0,11,8,19,1,8,5.26315789473684,42.1052631578947,42.1052631578947,57.8947368421053
"536","90","2",6,1,1,1,2,0,0,1,2,1,1,0,1,1,1,0,15,7,22,6,1,27.2727272727273,4.54545454545455,31.8181818181818,68.1818181818182
"537","90","3",0,0,2,2,2,5,3,0,0,4,5,2,1,2,0,0,15,16,31,0,10,0,32.258064516129,51.6129032258064,48.3870967741936
"538","90","4",0,0,2,0,2,5,2,0,1,2,4,2,1,1,0,0,14,11,25,0,9,0,36,44,56
"539","90","5",2,1,2,0,1,2,2,0,1,1,0,2,1,1,0,0,11,8,19,2,2,10.5263157894737,10.5263157894737,42.1052631578947,57.8947368421053
"540","90","6",1,1,1,0,1,0,0,0,1,1,0,0,1,0,1,0,6,5,11,1,0,9.09090909090909,0,45.4545454545455,54.5454545454545
"541","91","1",0,0,0,1,1,2,1,2,0,1,3,2,0,2,1,4,7,16,23,4,5,17.3913043478261,21.7391304347826,69.5652173913043,30.4347826086957
"542","91","2",0,0,2,0,1,4,3,0,1,2,3,3,2,1,0,0,13,12,25,0,7,0,28,48,52
"543","91","3",0,0,1,2,1,1,3,2,1,2,1,3,2,3,2,1,13,15,28,1,2,3.57142857142857,7.14285714285714,53.5714285714286,46.4285714285714
"544","91","4",0,0,2,0,1,5,2,2,0,2,4,3,2,2,2,2,14,18,32,2,9,6.25,28.125,56.25,43.75
"545","91","5",0,1,2,1,3,1,1,1,1,2,2,1,0,2,1,2,12,12,24,2,3,8.33333333333333,12.5,50,50
"546","91","6",0,0,0,1,0,2,2,2,0,1,2,3,1,3,3,3,8,18,26,3,4,11.5384615384615,15.3846153846154,69.2307692307692,30.7692307692308
"547","92","1",1,1,1,0,1,11,0,0,1,0,11,0,0,0,0,0,17,13,30,1,22,3.33333333333333,73.3333333333333,43.3333333333333,56.6666666666667
"548","92","2",0,0,3,0,1,5,3,1,0,3,4,4,2,2,1,1,15,18,33,1,9,3.03030303030303,27.2727272727273,54.5454545454545,45.4545454545455
"549","92","3",0,0,0,0,0,4,0,0,0,0,4,1,0,0,0,0,5,7,12,0,8,0,66.6666666666667,58.3333333333333,41.6666666666667
"550","92","4",1,1,1,2,2,3,0,3,1,1,4,1,0,3,3,4,14,19,33,5,7,15.1515151515152,21.2121212121212,57.5757575757576,42.4242424242424
"551","92","5",1,2,2,1,3,0,0,1,3,1,0,0,1,0,1,1,13,7,20,2,0,10,0,35,65
"552","92","6",1,1,2,0,1,11,1,0,0,1,11,1,0,1,0,0,19,15,34,1,22,2.94117647058824,64.7058823529412,44.1176470588235,55.8823529411765
"553","95","1",0,2,4,1,3,4,2,1,2,2,4,2,1,2,1,1,19,16,35,1,8,2.85714285714286,22.8571428571429,45.7142857142857,54.2857142857143
"554","95","2",0,2,1,1,1,1,1,0,1,0,1,1,0,1,0,0,8,6,14,0,2,0,14.2857142857143,42.8571428571429,57.1428571428571
"555","95","3",0,1,0,1,0,1,1,1,1,0,1,2,1,2,1,0,6,10,16,0,2,0,12.5,62.5,37.5
"556","95","4",0,0,1,2,1,1,1,1,0,3,1,0,2,1,2,2,8,13,21,2,2,9.52380952380952,9.52380952380952,61.9047619047619,38.0952380952381
"557","95","5",2,1,0,0,0,1,1,0,1,0,0,1,1,0,0,0,7,4,11,2,1,18.1818181818182,9.09090909090909,36.3636363636364,63.6363636363636
"558","95","6",0,0,0,0,0,0,0,0,0,0,0,0,0,0,0,0,2,1,3,0,0,0,0,33.3333333333333,66.6666666666667
"559","96","1",1,3,4,3,4,3,2,1,3,3,3,0,3,0,1,2,23,16,39,3,6,7.69230769230769,15.3846153846154,41.025641025641,58.974358974359
"560","96","2",0,1,0,1,1,0,0,1,1,0,1,1,0,2,2,3,5,12,17,3,1,17.6470588235294,5.88235294117647,70.5882352941177,29.4117647058824
"561","96","3",1,1,1,1,0,1,0,1,1,1,0,0,1,0,1,1,7,7,14,2,1,14.2857142857143,7.14285714285714,50,50
"562","96","4",2,2,2,1,1,4,0,1,1,1,4,0,1,0,1,2,15,11,26,4,8,15.3846153846154,30.7692307692308,42.3076923076923,57.6923076923077
"563","96","5",2,2,2,1,2,1,2,1,2,1,1,1,1,1,0,0,13,10,23,2,2,8.69565217391304,8.69565217391304,43.4782608695652,56.5217391304348
"564","96","6",1,1,0,0,1,0,0,0,1,0,1,0,0,1,0,0,5,4,9,1,1,11.1111111111111,11.1111111111111,44.4444444444444,55.5555555555556
